trID	epochTime	oldVer	newVer	humanTime	distFromV0InDays	runningYearFromV0	runningMonthFromV0	#numOldTables	#numNewTables	#numOldAttrs	#numNewAttrs	tablesIns	tablesDel	attrsInsWithTableIns	attrsbDelWithTableDel	attrsInjected	attrsEjected	attrsWithTypeUpd	attrsInPKUpd	tableDelta	attrDelta	attrBirthsSum	attrDeathsSum	attrUpdsSum	Expansion	Maintenance	TotalAttrActivity	
0	1234373148		1234373148.sql	2009-02-11 17:25:48	0	0	0		48		297	48	0	297	0	0	0	0	0			297	0	0	297	0	297	
1	1237164239	1234373148.sql	1237164239.sql	2009-03-16 00:43:59	32	1	2	48	46	297	292	6	8	23	30	6	4	12	0	-2	-5	29	34	12	29	46	75	
2	1237208478	1237164239.sql	1237208478.sql	2009-03-16 13:01:18	32	1	2	46	46	292	292	0	0	0	0	0	0	0	0	0	0	0	0	0	0	0	0	
3	1237218277	1237208478.sql	1237218277.sql	2009-03-16 15:44:37	32	1	2	46	46	292	292	0	0	0	0	0	0	0	0	0	0	0	0	0	0	0	0	
4	1237253648	1237218277.sql	1237253648.sql	2009-03-17 01:34:08	33	1	2	46	46	292	292	0	0	0	0	0	0	0	0	0	0	0	0	0	0	0	0	
5	1237391769	1237253648.sql	1237391769.sql	2009-03-18 15:56:09	34	1	2	46	46	292	292	0	0	0	0	0	0	0	0	0	0	0	0	0	0	0	0	
6	1237392520	1237391769.sql	1237392520.sql	2009-03-18 16:08:40	34	1	2	46	46	292	292	0	0	0	0	0	0	0	0	0	0	0	0	0	0	0	0	
7	1237471882	1237392520.sql	1237471882.sql	2009-03-19 14:11:22	35	1	2	46	46	292	292	0	0	0	0	0	0	0	0	0	0	0	0	0	0	0	0	
8	1237481892	1237471882.sql	1237481892.sql	2009-03-19 16:58:12	35	1	2	46	46	292	292	0	0	0	0	0	0	0	0	0	0	0	0	0	0	0	0	
9	1237572660	1237481892.sql	1237572660.sql	2009-03-20 18:11:00	37	1	2	46	46	292	292	0	0	0	0	0	0	0	0	0	0	0	0	0	0	0	0	
10	1237572808	1237572660.sql	1237572808.sql	2009-03-20 18:13:28	37	1	2	46	46	292	292	0	0	0	0	0	0	0	0	0	0	0	0	0	0	0	0	
11	1237574023	1237572808.sql	1237574023.sql	2009-03-20 18:33:43	37	1	2	46	46	292	292	0	0	0	0	0	0	0	0	0	0	0	0	0	0	0	0	
12	1237857462	1237574023.sql	1237857462.sql	2009-03-24 01:17:42	40	1	2	46	46	292	294	0	0	0	0	2	0	0	0	0	2	2	0	0	2	0	2	
13	1238121825	1237857462.sql	1238121825.sql	2009-03-27 02:43:45	43	1	2	46	47	294	299	1	0	5	0	0	0	0	0	1	5	5	0	0	5	0	5	
14	1239235332	1238121825.sql	1239235332.sql	2009-04-09 00:02:12	56	1	2	47	48	299	301	1	0	2	0	1	1	6	0	1	2	3	1	6	3	7	10	
15	1241435169	1239235332.sql	1241435169.sql	2009-05-04 11:06:09	81	1	3	48	47	301	297	0	1	0	5	1	0	0	0	-1	-4	1	5	0	1	5	6	
16	1241730214	1241435169.sql	1241730214.sql	2009-05-07 21:03:34	85	1	3	47	47	297	297	0	0	0	0	0	0	2	0	0	0	0	0	2	0	2	2	
17	1245377084	1241730214.sql	1245377084.sql	2009-06-19 02:04:44	127	1	5	47	48	297	305	48	47	305	297	0	0	0	0	1	8	305	297	0	305	297	602	
18	1248223570	1245377084.sql	1248223570.sql	2009-07-22 00:46:10	160	1	6	48	48	305	304	48	48	304	305	0	0	0	0	0	-1	304	305	0	304	305	609	
19	1257375862	1248223570.sql	1257375862.sql	2009-11-04 23:04:22	266	1	9	48	50	304	313	3	1	9	5	7	2	0	0	2	9	16	7	0	16	7	23	
20	1257376170	1257375862.sql	1257376170.sql	2009-11-04 23:09:30	266	1	9	50	51	313	320	1	0	7	0	0	0	0	0	1	7	7	0	0	7	0	7	
21	1257387545	1257376170.sql	1257387545.sql	2009-11-05 02:19:05	266	1	9	51	51	320	329	0	0	0	0	10	1	3	0	0	9	10	1	3	10	4	14	
22	1268139768	1257387545.sql	1268139768.sql	2010-03-09 13:02:48	390	2	13	51	51	329	329	0	0	0	0	0	0	0	0	0	0	0	0	0	0	0	0	
23	1268142021	1268139768.sql	1268142021.sql	2010-03-09 13:40:21	390	2	13	51	57	329	382	57	51	382	329	0	0	0	0	6	53	382	329	0	382	329	711	
24	1268415531	1268142021.sql	1268415531.sql	2010-03-12 17:38:51	394	2	14	57	57	382	383	0	0	0	0	1	0	0	0	0	1	1	0	0	1	0	1	
25	1268676441	1268415531.sql	1268676441.sql	2010-03-15 18:07:21	397	2	14	57	57	383	383	0	0	0	0	0	0	0	0	0	0	0	0	0	0	0	0	
26	1269721303	1268676441.sql	1269721303.sql	2010-03-27 20:21:43	409	2	14	57	57	383	385	0	0	0	0	3	1	0	0	0	2	3	1	0	3	1	4	
27	1269876626	1269721303.sql	1269876626.sql	2010-03-29 15:30:26	410	2	14	57	57	385	385	0	0	0	0	0	0	0	0	0	0	0	0	0	0	0	0	
28	1270963400	1269876626.sql	1270963400.sql	2010-04-11 05:23:20	423	2	14	57	59	385	395	2	0	4	0	6	0	0	0	2	10	10	0	0	10	0	10	
29	1275492351	1270963400.sql	1275492351.sql	2010-06-02 15:25:51	475	2	16	59	59	395	401	0	0	0	0	7	1	1	0	0	6	7	1	1	7	2	9	
30	1275494700	1275492351.sql	1275494700.sql	2010-06-02 16:05:00	475	2	16	59	59	401	401	0	0	0	0	0	0	0	0	0	0	0	0	0	0	0	0	
31	1282938855	1275494700.sql	1282938855.sql	2010-08-27 19:54:15	562	2	19	59	59	401	401	0	0	0	0	1	1	0	0	0	0	1	1	0	1	1	2	
32	1288139094	1282938855.sql	1288139094.sql	2010-10-27 00:24:54	622	2	21	59	59	401	401	0	0	0	0	0	0	0	0	0	0	0	0	0	0	0	0	
33	1290311335	1288139094.sql	1290311335.sql	2010-11-21 03:48:55	647	2	22	59	59	401	401	0	0	0	0	0	0	0	0	0	0	0	0	0	0	0	0	
34	1303880377	1290311335.sql	1303880377.sql	2011-04-27 04:59:37	804	3	27	59	59	401	402	0	0	0	0	1	0	1	0	0	1	1	0	1	1	1	2	
35	1303916686	1303880377.sql	1303916686.sql	2011-04-27 15:04:46	804	3	27	59	85	402	528	32	6	169	19	26	50	4	0	26	126	195	69	4	195	73	268	
36	1304007481	1303916686.sql	1304007481.sql	2011-04-28 16:18:01	805	3	27	85	85	528	528	0	0	0	0	0	0	0	0	0	0	0	0	0	0	0	0	
37	1304094671	1304007481.sql	1304094671.sql	2011-04-29 16:31:11	806	3	27	85	88	528	539	3	0	11	0	1	1	0	0	3	11	12	1	0	12	1	13	
38	1304787950	1304094671.sql	1304787950.sql	2011-05-07 17:05:50	814	3	27	88	88	539	540	0	0	0	0	1	0	0	0	0	1	1	0	0	1	0	1	
39	1305005407	1304787950.sql	1305005407.sql	2011-05-10 05:30:07	817	3	27	88	88	540	540	0	0	0	0	3	3	0	0	0	0	3	3	0	3	3	6	
40	1305264403	1305005407.sql	1305264403.sql	2011-05-13 05:26:43	820	3	28	88	88	540	540	0	0	0	0	0	0	0	0	0	0	0	0	0	0	0	0	
41	1306160795	1305264403.sql	1306160795.sql	2011-05-23 14:26:35	830	3	28	88	88	540	542	0	0	0	0	2	0	0	0	0	2	2	0	0	2	0	2	
42	1306242594	1306160795.sql	1306242594.sql	2011-05-24 13:09:54	831	3	28	88	88	542	542	0	0	0	0	0	0	0	0	0	0	0	0	0	0	0	0	
43	1306242787	1306242594.sql	1306242787.sql	2011-05-24 13:13:07	831	3	28	88	88	542	542	0	0	0	0	0	0	0	0	0	0	0	0	0	0	0	0	
44	1306252813	1306242787.sql	1306252813.sql	2011-05-24 16:00:13	831	3	28	88	88	542	542	0	0	0	0	0	0	0	0	0	0	0	0	0	0	0	0	
45	1306384114	1306252813.sql	1306384114.sql	2011-05-26 04:28:34	833	3	28	88	88	542	542	0	0	0	0	0	0	0	0	0	0	0	0	0	0	0	0	
46	1306778226	1306384114.sql	1306778226.sql	2011-05-30 17:57:06	838	3	28	88	88	542	542	0	0	0	0	0	0	0	0	0	0	0	0	0	0	0	0	
47	1307278299	1306778226.sql	1307278299.sql	2011-06-05 12:51:39	843	3	28	88	88	542	542	0	0	0	0	0	0	0	0	0	0	0	0	0	0	0	0	
48	1309618117	1307278299.sql	1309618117.sql	2011-07-02 14:48:37	870	3	29	88	88	542	542	0	0	0	0	0	0	28	0	0	0	0	0	28	0	28	28	
49	1309618531	1309618117.sql	1309618531.sql	2011-07-02 14:55:31	870	3	29	88	88	542	542	0	0	0	0	0	0	0	0	0	0	0	0	0	0	0	0	
50	1309618648	1309618531.sql	1309618648.sql	2011-07-02 14:57:28	870	3	29	88	88	542	542	0	0	0	0	0	0	0	0	0	0	0	0	0	0	0	0	
51	1309620135	1309618648.sql	1309620135.sql	2011-07-02 15:22:15	870	3	29	88	88	542	543	0	0	0	0	1	0	0	0	0	1	1	0	0	1	0	1	
52	1309789238	1309620135.sql	1309789238.sql	2011-07-04 14:20:38	872	3	29	88	88	543	543	0	0	0	0	0	0	0	0	0	0	0	0	0	0	0	0	
53	1310835774	1309789238.sql	1310835774.sql	2011-07-16 17:02:54	884	3	30	88	88	543	543	0	0	0	0	0	0	0	0	0	0	0	0	0	0	0	0	
54	1311011574	1310835774.sql	1311011574.sql	2011-07-18 17:52:54	887	3	30	88	88	543	543	0	0	0	0	0	0	0	0	0	0	0	0	0	0	0	0	
55	1311073062	1311011574.sql	1311073062.sql	2011-07-19 10:57:42	887	3	30	88	88	543	543	0	0	0	0	0	0	0	0	0	0	0	0	0	0	0	0	
56	1311348729	1311073062.sql	1311348729.sql	2011-07-22 15:32:09	890	3	30	88	88	543	543	0	0	0	0	0	0	0	0	0	0	0	0	0	0	0	0	
57	1311480397	1311348729.sql	1311480397.sql	2011-07-24 04:06:37	892	3	30	88	88	543	544	0	0	0	0	1	0	0	0	0	1	1	0	0	1	0	1	
58	1340381450	1311480397.sql	1340381450.sql	2012-06-22 16:10:50	1226	4	41	88	95	544	643	8	1	86	10	28	5	6	0	7	99	114	15	6	114	21	135	
59	1343018521	1340381450.sql	1343018521.sql	2012-07-23 04:42:01	1257	4	42	95	94	643	640	0	1	0	4	1	0	0	0	-1	-3	1	4	0	1	4	5	
60	1343052759	1343018521.sql	1343052759.sql	2012-07-23 14:12:39	1257	4	42	94	94	640	640	0	0	0	0	0	0	1	0	0	0	0	0	1	0	1	1	
61	1343054421	1343052759.sql	1343054421.sql	2012-07-23 14:40:21	1257	4	42	94	94	640	644	0	0	0	0	4	0	0	0	0	4	4	0	0	4	0	4	
62	1343135708	1343054421.sql	1343135708.sql	2012-07-24 13:15:08	1258	4	42	94	94	644	644	0	0	0	0	0	0	6	0	0	0	0	0	6	0	6	6	
63	1343218320	1343135708.sql	1343218320.sql	2012-07-25 12:12:00	1259	4	42	94	94	644	644	0	0	0	0	0	0	2	0	0	0	0	0	2	0	2	2	
64	1344106890	1343218320.sql	1344106890.sql	2012-08-04 19:01:30	1270	4	42	94	94	644	644	0	0	0	0	0	0	0	0	0	0	0	0	0	0	0	0	
65	1344597033	1344106890.sql	1344597033.sql	2012-08-10 11:10:33	1275	4	42	94	94	644	647	0	0	0	0	3	0	0	0	0	3	3	0	0	3	0	3	
66	1344700758	1344597033.sql	1344700758.sql	2012-08-11 15:59:18	1276	4	42	94	93	647	644	0	1	0	3	0	0	0	0	-1	-3	0	3	0	0	3	3	
67	1344723662	1344700758.sql	1344723662.sql	2012-08-11 22:21:02	1277	4	43	93	94	644	647	1	0	3	0	0	0	0	0	1	3	3	0	0	3	0	3	
68	1344864251	1344723662.sql	1344864251.sql	2012-08-13 13:24:11	1278	4	43	94	94	647	647	0	0	0	0	0	0	0	0	0	0	0	0	0	0	0	0	
69	1344866445	1344864251.sql	1344866445.sql	2012-08-13 14:00:45	1278	4	43	94	93	647	644	0	1	0	3	0	0	0	0	-1	-3	0	3	0	0	3	3	
70	1344869717	1344866445.sql	1344869717.sql	2012-08-13 14:55:17	1278	4	43	93	93	644	644	0	0	0	0	0	0	0	0	0	0	0	0	0	0	0	0	
71	1344874065	1344869717.sql	1344874065.sql	2012-08-13 16:07:45	1278	4	43	93	93	644	644	0	0	0	0	0	0	1	0	0	0	0	0	1	0	1	1	
72	1344933477	1344874065.sql	1344933477.sql	2012-08-14 08:37:57	1279	4	43	93	93	644	644	0	0	0	0	0	0	0	0	0	0	0	0	0	0	0	0	
73	1345488827	1344933477.sql	1345488827.sql	2012-08-20 18:53:47	1286	4	43	93	93	644	644	0	0	0	0	0	0	0	0	0	0	0	0	0	0	0	0	
74	1345720851	1345488827.sql	1345720851.sql	2012-08-23 11:20:51	1288	4	43	93	93	644	644	0	0	0	0	0	0	0	0	0	0	0	0	0	0	0	0	
75	1345740435	1345720851.sql	1345740435.sql	2012-08-23 16:47:15	1288	4	43	93	93	644	644	0	0	0	0	0	0	0	0	0	0	0	0	0	0	0	0	
76	1346047283	1345740435.sql	1346047283.sql	2012-08-27 06:01:23	1292	4	43	93	93	644	644	0	0	0	0	0	0	1	0	0	0	0	0	1	0	1	1	
77	1346314380	1346047283.sql	1346314380.sql	2012-08-30 08:13:00	1295	4	43	93	93	644	644	0	0	0	0	0	0	0	0	0	0	0	0	0	0	0	0	
78	1346344444	1346314380.sql	1346344444.sql	2012-08-30 16:34:04	1295	4	43	93	93	644	644	0	0	0	0	0	0	0	0	0	0	0	0	0	0	0	0	
79	1346394698	1346344444.sql	1346394698.sql	2012-08-31 06:31:38	1296	4	43	93	93	644	644	0	0	0	0	0	0	0	0	0	0	0	0	0	0	0	0	
80	1346487959	1346394698.sql	1346487959.sql	2012-09-01 08:25:59	1297	4	43	93	93	644	644	0	0	0	0	0	0	0	0	0	0	0	0	0	0	0	0	
81	1346556353	1346487959.sql	1346556353.sql	2012-09-02 03:25:53	1298	4	43	93	93	644	644	0	0	0	0	0	0	0	0	0	0	0	0	0	0	0	0	
82	1346557985	1346556353.sql	1346557985.sql	2012-09-02 03:53:05	1298	4	43	93	93	644	644	0	0	0	0	0	0	0	0	0	0	0	0	0	0	0	0	
83	1346873075	1346557985.sql	1346873075.sql	2012-09-05 19:24:35	1302	4	43	93	93	644	644	0	0	0	0	0	0	0	0	0	0	0	0	0	0	0	0	
84	1347205032	1346873075.sql	1347205032.sql	2012-09-09 15:37:12	1305	4	43	93	98	644	659	5	0	14	0	1	0	0	0	5	15	15	0	0	15	0	15	
85	1348137450	1347205032.sql	1348137450.sql	2012-09-20 10:37:30	1316	4	44	98	99	659	662	1	0	2	0	2	1	0	0	1	3	4	1	0	4	1	5	
86	1348502526	1348137450.sql	1348502526.sql	2012-09-24 16:02:06	1320	4	44	99	99	662	663	0	0	0	0	1	0	0	0	0	1	1	0	0	1	0	1	
87	1348848887	1348502526.sql	1348848887.sql	2012-09-28 16:14:47	1324	4	44	99	99	663	663	0	0	0	0	0	0	0	0	0	0	0	0	0	0	0	0	
88	1350003218	1348848887.sql	1350003218.sql	2012-10-12 00:53:38	1338	4	45	99	99	663	663	0	0	0	0	0	0	0	0	0	0	0	0	0	0	0	0	
89	1353402218	1350003218.sql	1353402218.sql	2012-11-20 09:03:38	1377	4	46	99	99	663	663	0	0	0	0	0	0	0	0	0	0	0	0	0	0	0	0	
90	1354253034	1353402218.sql	1354253034.sql	2012-11-30 05:23:54	1387	4	46	99	99	663	663	0	0	0	0	0	0	0	0	0	0	0	0	0	0	0	0	
91	1354439544	1354253034.sql	1354439544.sql	2012-12-02 09:12:24	1389	4	46	99	100	663	666	1	0	3	0	0	0	0	0	1	3	3	0	0	3	0	3	
92	1354441892	1354439544.sql	1354441892.sql	2012-12-02 09:51:32	1389	4	46	100	100	666	666	0	0	0	0	1	1	0	0	0	0	1	1	0	1	1	2	
93	1354547184	1354441892.sql	1354547184.sql	2012-12-03 15:06:24	1390	4	46	100	100	666	666	0	0	0	0	0	0	0	0	0	0	0	0	0	0	0	0	
94	1354589890	1354547184.sql	1354589890.sql	2012-12-04 02:58:10	1391	4	46	100	100	666	666	0	0	0	0	0	0	0	0	0	0	0	0	0	0	0	0	
95	1354714802	1354589890.sql	1354714802.sql	2012-12-05 13:40:02	1392	4	46	100	100	666	666	0	0	0	0	0	0	0	0	0	0	0	0	0	0	0	0	
96	1354983617	1354714802.sql	1354983617.sql	2012-12-08 16:20:17	1395	4	46	100	101	666	668	3	2	7	7	2	0	0	0	1	2	9	7	0	9	7	16	
97	1355066290	1354983617.sql	1355066290.sql	2012-12-09 15:18:10	1396	4	46	101	101	668	667	0	0	0	0	0	1	0	0	0	-1	0	1	0	0	1	1	
98	1355383912	1355066290.sql	1355383912.sql	2012-12-13 07:31:52	1400	4	47	101	101	667	665	0	0	0	0	0	2	0	0	0	-2	0	2	0	0	2	2	
99	1355439526	1355383912.sql	1355439526.sql	2012-12-13 22:58:46	1401	4	47	101	101	665	665	0	0	0	0	0	0	0	0	0	0	0	0	0	0	0	0	
100	1355496034	1355439526.sql	1355496034.sql	2012-12-14 14:40:34	1401	4	47	101	101	665	665	0	0	0	0	0	0	0	0	0	0	0	0	0	0	0	0	
101	1355544856	1355496034.sql	1355544856.sql	2012-12-15 04:14:16	1402	4	47	101	102	665	669	1	0	4	0	0	0	0	0	1	4	4	0	0	4	0	4	
102	1355589626	1355544856.sql	1355589626.sql	2012-12-15 16:40:26	1402	4	47	102	109	669	699	7	0	30	0	0	0	0	0	7	30	30	0	0	30	0	30	
103	1355764690	1355589626.sql	1355764690.sql	2012-12-17 17:18:10	1404	4	47	109	109	699	699	0	0	0	0	0	0	33	0	0	0	0	0	33	0	33	33	
104	1355804575	1355764690.sql	1355804575.sql	2012-12-18 04:22:55	1405	4	47	109	109	699	699	0	0	0	0	0	0	0	0	0	0	0	0	0	0	0	0	
105	1355825240	1355804575.sql	1355825240.sql	2012-12-18 10:07:20	1405	4	47	109	109	699	699	0	0	0	0	0	0	0	0	0	0	0	0	0	0	0	0	
106	1356265761	1355825240.sql	1356265761.sql	2012-12-23 12:29:21	1410	4	47	109	109	699	699	0	0	0	0	0	0	0	0	0	0	0	0	0	0	0	0	
107	1356516717	1356265761.sql	1356516717.sql	2012-12-26 10:11:57	1413	4	47	109	109	699	699	1	1	2	2	0	0	0	0	0	0	2	2	0	2	2	4	
108	1356581856	1356516717.sql	1356581856.sql	2012-12-27 04:17:36	1414	4	47	109	109	699	699	0	0	0	0	0	0	0	0	0	0	0	0	0	0	0	0	
109	1356595320	1356581856.sql	1356595320.sql	2012-12-27 08:02:00	1414	4	47	109	109	699	699	0	0	0	0	0	0	0	0	0	0	0	0	0	0	0	0	
110	1357221079	1356595320.sql	1357221079.sql	2013-01-03 13:51:19	1421	4	47	109	110	699	701	1	0	2	0	0	0	0	0	1	2	2	0	0	2	0	2	
111	1357232003	1357221079.sql	1357232003.sql	2013-01-03 16:53:23	1421	4	47	110	110	701	701	0	0	0	0	0	0	1	0	0	0	0	0	1	0	1	1	
112	1357264153	1357232003.sql	1357264153.sql	2013-01-04 01:49:13	1422	4	47	110	110	701	701	0	0	0	0	0	0	0	0	0	0	0	0	0	0	0	0	
113	1357283233	1357264153.sql	1357283233.sql	2013-01-04 07:07:13	1422	4	47	110	110	701	702	0	0	0	0	1	0	0	0	0	1	1	0	0	1	0	1	
114	1357779035	1357283233.sql	1357779035.sql	2013-01-10 00:50:35	1428	4	47	110	110	702	702	0	0	0	0	0	0	19	0	0	0	0	0	19	0	19	19	
115	1358168652	1357779035.sql	1358168652.sql	2013-01-14 13:04:12	1432	4	48	110	110	702	702	0	0	0	0	0	0	19	0	0	0	0	0	19	0	19	19	
116	1358500805	1358168652.sql	1358500805.sql	2013-01-18 09:20:05	1436	4	48	110	109	702	700	0	1	0	2	0	0	0	0	-1	-2	0	2	0	0	2	2	
117	1358607874	1358500805.sql	1358607874.sql	2013-01-19 15:04:34	1437	4	48	109	109	700	700	1	1	2	2	0	0	0	0	0	0	2	2	0	2	2	4	
118	1359021839	1358607874.sql	1359021839.sql	2013-01-24 10:03:59	1442	4	48	109	110	700	698	1	0	3	0	0	5	0	0	1	-2	3	5	0	3	5	8	
119	1359140232	1359021839.sql	1359140232.sql	2013-01-25 18:57:12	1444	4	48	110	110	698	698	0	0	0	0	0	0	0	0	0	0	0	0	0	0	0	0	
120	1359141776	1359140232.sql	1359141776.sql	2013-01-25 19:22:56	1444	4	48	110	110	698	698	0	0	0	0	0	0	0	0	0	0	0	0	0	0	0	0	
121	1359142072	1359141776.sql	1359142072.sql	2013-01-25 19:27:52	1444	4	48	110	110	698	698	0	0	0	0	0	0	0	0	0	0	0	0	0	0	0	0	
122	1359143993	1359142072.sql	1359143993.sql	2013-01-25 19:59:53	1444	4	48	110	110	698	698	0	0	0	0	0	0	0	0	0	0	0	0	0	0	0	0	
123	1359168600	1359143993.sql	1359168600.sql	2013-01-26 02:50:00	1444	4	48	110	110	698	698	0	0	0	0	0	0	0	0	0	0	0	0	0	0	0	0	
124	1359283394	1359168600.sql	1359283394.sql	2013-01-27 10:43:14	1445	4	48	110	110	698	698	0	0	0	0	0	0	1	0	0	0	0	0	1	0	1	1	
125	1359378239	1359283394.sql	1359378239.sql	2013-01-28 13:03:59	1446	4	48	110	110	698	698	0	0	0	0	0	0	0	0	0	0	0	0	0	0	0	0	
126	1359392592	1359378239.sql	1359392592.sql	2013-01-28 17:03:12	1446	4	48	110	110	698	698	0	0	0	0	0	0	0	0	0	0	0	0	0	0	0	0	
127	1359462435	1359392592.sql	1359462435.sql	2013-01-29 12:27:15	1447	4	48	110	110	698	698	0	0	0	0	0	0	0	0	0	0	0	0	0	0	0	0	
128	1359542842	1359462435.sql	1359542842.sql	2013-01-30 10:47:22	1448	4	48	110	110	698	698	0	0	0	0	1	1	0	0	0	0	1	1	0	1	1	2	
129	1359545918	1359542842.sql	1359545918.sql	2013-01-30 11:38:38	1448	4	48	110	110	698	698	0	0	0	0	0	0	0	0	0	0	0	0	0	0	0	0	
130	1359906971	1359545918.sql	1359906971.sql	2013-02-03 15:56:11	1452	4	48	110	110	698	694	0	0	0	0	0	4	0	0	0	-4	0	4	0	0	4	4	
131	1359953298	1359906971.sql	1359953298.sql	2013-02-04 04:48:18	1453	4	48	110	110	694	694	0	0	0	0	0	0	4	0	0	0	0	0	4	0	4	4	
132	1359987944	1359953298.sql	1359987944.sql	2013-02-04 14:25:44	1453	4	48	110	110	694	694	0	0	0	0	0	0	0	0	0	0	0	0	0	0	0	0	
133	1359990053	1359987944.sql	1359990053.sql	2013-02-04 15:00:53	1453	4	48	110	110	694	694	0	0	0	0	0	0	0	0	0	0	0	0	0	0	0	0	
134	1360320633	1359990053.sql	1360320633.sql	2013-02-08 10:50:33	1457	4	48	110	110	694	695	0	0	0	0	1	0	0	0	0	1	1	0	0	1	0	1	
135	1360502650	1360320633.sql	1360502650.sql	2013-02-10 13:24:10	1459	4	48	110	110	695	695	0	0	0	0	0	0	0	0	0	0	0	0	0	0	0	0	
136	1360502814	1360502650.sql	1360502814.sql	2013-02-10 13:26:54	1459	4	48	110	110	695	695	0	0	0	0	0	0	0	0	0	0	0	0	0	0	0	0	
137	1360877393	1360502814.sql	1360877393.sql	2013-02-14 21:29:53	1464	5	49	110	110	695	695	0	0	0	0	0	0	0	0	0	0	0	0	0	0	0	0	
138	1361016236	1360877393.sql	1361016236.sql	2013-02-16 12:03:56	1465	5	49	110	110	695	695	0	0	0	0	0	0	0	0	0	0	0	0	0	0	0	0	
139	1361250368	1361016236.sql	1361250368.sql	2013-02-19 05:06:08	1468	5	49	110	111	695	707	1	0	12	0	0	0	0	0	1	12	12	0	0	12	0	12	
140	1361270644	1361250368.sql	1361270644.sql	2013-02-19 10:44:04	1468	5	49	111	111	707	707	0	0	0	0	2	2	0	1	0	0	2	2	1	2	3	5	
141	1361273464	1361270644.sql	1361273464.sql	2013-02-19 11:31:04	1468	5	49	111	111	707	707	0	0	0	0	1	1	0	0	0	0	1	1	0	1	1	2	
142	1361295174	1361273464.sql	1361295174.sql	2013-02-19 17:32:54	1469	5	49	111	111	707	707	0	0	0	0	0	0	0	0	0	0	0	0	0	0	0	0	
143	1361297656	1361295174.sql	1361297656.sql	2013-02-19 18:14:16	1469	5	49	111	111	707	707	0	0	0	0	0	0	0	1	0	0	0	0	1	0	1	1	
144	1361320292	1361297656.sql	1361320292.sql	2013-02-20 00:31:32	1469	5	49	111	111	707	707	0	0	0	0	0	0	0	0	0	0	0	0	0	0	0	0	
145	1361624230	1361320292.sql	1361624230.sql	2013-02-23 12:57:10	1472	5	49	111	111	707	707	0	0	0	0	0	0	0	0	0	0	0	0	0	0	0	0	
146	1361984122	1361624230.sql	1361984122.sql	2013-02-27 16:55:22	1476	5	49	111	112	707	714	1	0	7	0	0	0	0	0	1	7	7	0	0	7	0	7	
147	1362113277	1361984122.sql	1362113277.sql	2013-03-01 04:47:57	1478	5	49	112	112	714	715	0	0	0	0	1	0	0	0	0	1	1	0	0	1	0	1	
148	1362248254	1362113277.sql	1362248254.sql	2013-03-02 18:17:34	1480	5	49	112	112	715	715	0	0	0	0	0	0	0	0	0	0	0	0	0	0	0	0	
149	1362968361	1362248254.sql	1362968361.sql	2013-03-11 02:19:21	1488	5	49	112	112	715	715	0	0	0	0	0	0	0	0	0	0	0	0	0	0	0	0	
150	1363327463	1362968361.sql	1363327463.sql	2013-03-15 06:04:23	1492	5	50	112	112	715	715	0	0	0	0	0	0	0	0	0	0	0	0	0	0	0	0	
151	1363449659	1363327463.sql	1363449659.sql	2013-03-16 16:00:59	1493	5	50	112	112	715	715	0	0	0	0	1	1	1	0	0	0	1	1	1	1	2	3	
152	1363950938	1363449659.sql	1363950938.sql	2013-03-22 11:15:38	1499	5	50	112	112	715	716	0	0	0	0	1	0	0	0	0	1	1	0	0	1	0	1	
153	1368076870	1363950938.sql	1368076870.sql	2013-05-09 05:21:10	1547	5	51	112	112	716	717	0	0	0	0	1	0	0	0	0	1	1	0	0	1	0	1	
154	1371272304	1368076870.sql	1371272304.sql	2013-06-15 04:58:24	1584	5	53	112	112	717	718	0	0	0	0	1	0	0	0	0	1	1	0	0	1	0	1	
155	1371395916	1371272304.sql	1371395916.sql	2013-06-16 15:18:36	1585	5	53	112	113	718	725	1	0	6	0	1	0	0	0	1	7	7	0	0	7	0	7	
156	1371472419	1371395916.sql	1371472419.sql	2013-06-17 12:33:39	1586	5	53	113	113	725	725	0	0	0	0	0	0	0	0	0	0	0	0	0	0	0	0	
157	1371539740	1371472419.sql	1371539740.sql	2013-06-18 07:15:40	1587	5	53	113	113	725	725	0	0	0	0	0	0	0	0	0	0	0	0	0	0	0	0	
158	1371543094	1371539740.sql	1371543094.sql	2013-06-18 08:11:34	1587	5	53	113	113	725	725	0	0	0	0	0	0	0	0	0	0	0	0	0	0	0	0	
159	1371543249	1371543094.sql	1371543249.sql	2013-06-18 08:14:09	1587	5	53	113	113	725	725	0	0	0	0	0	0	0	0	0	0	0	0	0	0	0	0	
160	1371561766	1371543249.sql	1371561766.sql	2013-06-18 13:22:46	1587	5	53	113	113	725	725	0	0	0	0	0	0	0	0	0	0	0	0	0	0	0	0	
161	1372137954	1371561766.sql	1372137954.sql	2013-06-25 05:25:54	1594	5	53	113	113	725	725	0	0	0	0	0	0	0	0	0	0	0	0	0	0	0	0	
162	1372573259	1372137954.sql	1372573259.sql	2013-06-30 06:20:59	1599	5	53	113	113	725	725	0	0	0	0	0	0	0	0	0	0	0	0	0	0	0	0	
163	1372919443	1372573259.sql	1372919443.sql	2013-07-04 06:30:43	1603	5	53	113	113	725	726	0	0	0	0	3	2	0	0	0	1	3	2	0	3	2	5	
164	1372940024	1372919443.sql	1372940024.sql	2013-07-04 12:13:44	1603	5	53	113	113	726	726	0	0	0	0	0	0	0	0	0	0	0	0	0	0	0	0	
165	1373256301	1372940024.sql	1373256301.sql	2013-07-08 04:05:01	1607	5	53	113	114	726	731	1	0	5	0	0	0	0	0	1	5	5	0	0	5	0	5	
166	1374047007	1373256301.sql	1374047007.sql	2013-07-17 07:43:27	1616	5	54	114	114	731	731	0	0	0	0	1	1	0	0	0	0	1	1	0	1	1	2	
167	1377540369	1374047007.sql	1377540369.sql	2013-08-26 18:06:09	1657	5	55	114	114	731	731	0	0	0	0	0	0	0	0	0	0	0	0	0	0	0	0	
168	1379588431	1377540369.sql	1379588431.sql	2013-09-19 11:00:31	1680	5	56	114	114	731	733	0	0	0	0	2	0	0	0	0	2	2	0	0	2	0	2	
169	1379665905	1379588431.sql	1379665905.sql	2013-09-20 08:31:45	1681	5	56	114	114	733	738	0	0	0	0	5	0	0	0	0	5	5	0	0	5	0	5	
170	1381107516	1379665905.sql	1381107516.sql	2013-10-07 00:58:36	1698	5	56	114	114	738	737	0	0	0	0	0	1	1	0	0	-1	0	1	1	0	2	2	
171	1381517691	1381107516.sql	1381517691.sql	2013-10-11 18:54:51	1703	5	57	114	113	737	737	0	1	0	2	2	0	0	0	-1	0	2	2	0	2	2	4	
172	1382208427	1381517691.sql	1382208427.sql	2013-10-19 18:47:07	1711	5	57	113	113	737	735	0	0	0	0	0	2	0	0	0	-2	0	2	0	0	2	2	
173	1382383235	1382208427.sql	1382383235.sql	2013-10-21 19:20:35	1713	5	57	113	115	735	743	2	0	8	0	0	0	0	0	2	8	8	0	0	8	0	8	
174	1382538738	1382383235.sql	1382538738.sql	2013-10-23 14:32:18	1714	5	57	115	113	743	735	0	2	0	8	0	0	0	0	-2	-8	0	8	0	0	8	8	
175	1383576794	1382538738.sql	1383576794.sql	2013-11-04 14:53:14	1726	5	57	113	113	735	736	0	0	0	0	1	0	0	0	0	1	1	0	0	1	0	1	
176	1384347130	1383576794.sql	1384347130.sql	2013-11-13 12:52:10	1735	5	58	113	114	736	741	1	0	5	0	1	1	0	0	1	5	6	1	0	6	1	7	
177	1384755504	1384347130.sql	1384755504.sql	2013-11-18 06:18:24	1740	5	58	114	114	741	741	0	0	0	0	0	0	0	0	0	0	0	0	0	0	0	0	
178	1384839288	1384755504.sql	1384839288.sql	2013-11-19 05:34:48	1741	5	58	114	112	741	729	0	2	0	14	4	2	0	0	-2	-12	4	16	0	4	16	20	
179	1384863688	1384839288.sql	1384863688.sql	2013-11-19 12:21:28	1741	5	58	112	112	729	729	0	0	0	0	0	0	0	0	0	0	0	0	0	0	0	0	
180	1384866366	1384863688.sql	1384866366.sql	2013-11-19 13:06:06	1741	5	58	112	112	729	729	0	0	0	0	0	0	0	0	0	0	0	0	0	0	0	0	
181	1384940861	1384866366.sql	1384940861.sql	2013-11-20 09:47:41	1742	5	58	112	112	729	729	0	0	0	0	0	0	2	0	0	0	0	0	2	0	2	2	
182	1385443851	1384940861.sql	1385443851.sql	2013-11-26 05:30:51	1748	5	58	112	112	729	729	0	0	0	0	1	1	0	0	0	0	1	1	0	1	1	2	
183	1385473949	1385443851.sql	1385473949.sql	2013-11-26 13:52:29	1748	5	58	112	112	729	730	0	0	0	0	1	0	0	0	0	1	1	0	0	1	0	1	
184	1385706641	1385473949.sql	1385706641.sql	2013-11-29 06:30:41	1751	5	58	112	112	730	735	0	0	0	0	5	0	0	0	0	5	5	0	0	5	0	5	
185	1385831863	1385706641.sql	1385831863.sql	2013-11-30 17:17:43	1752	5	58	112	111	735	728	0	1	0	7	0	0	0	0	-1	-7	0	7	0	0	7	7	
186	1385989108	1385831863.sql	1385989108.sql	2013-12-02 12:58:28	1754	5	58	111	111	728	727	0	0	0	0	0	1	0	0	0	-1	0	1	0	0	1	1	
187	1386245583	1385989108.sql	1386245583.sql	2013-12-05 12:13:03	1757	5	58	111	111	727	722	0	0	0	0	1	6	0	0	0	-5	1	6	0	1	6	7	
188	1386303285	1386245583.sql	1386303285.sql	2013-12-06 04:14:45	1758	5	58	111	111	722	722	0	0	0	0	0	0	0	0	0	0	0	0	0	0	0	0	
189	1386456876	1386303285.sql	1386456876.sql	2013-12-07 22:54:36	1760	5	58	111	111	722	722	0	0	0	0	0	0	0	0	0	0	0	0	0	0	0	0	
190	1386616523	1386456876.sql	1386616523.sql	2013-12-09 19:15:23	1762	5	58	111	116	722	765	5	0	43	0	0	0	0	0	5	43	43	0	0	43	0	43	
191	1386628406	1386616523.sql	1386628406.sql	2013-12-09 22:33:26	1762	5	58	116	116	765	765	0	0	0	0	0	0	0	0	0	0	0	0	0	0	0	0	
192	1386752404	1386628406.sql	1386752404.sql	2013-12-11 09:00:04	1763	5	58	116	116	765	765	0	0	0	0	0	0	0	0	0	0	0	0	0	0	0	0	
193	1386892564	1386752404.sql	1386892564.sql	2013-12-12 23:56:04	1765	5	59	116	111	765	722	0	5	0	43	0	0	0	0	-5	-43	0	43	0	0	43	43	
194	1387033787	1386892564.sql	1387033787.sql	2013-12-14 15:09:47	1766	5	59	111	116	722	765	5	0	43	0	0	0	0	0	5	43	43	0	0	43	0	43	
195	1387839533	1387033787.sql	1387839533.sql	2013-12-23 22:58:53	1776	5	59	116	116	765	765	0	0	0	0	0	0	0	0	0	0	0	0	0	0	0	0	
196	1389776983	1387839533.sql	1389776983.sql	2014-01-15 09:09:43	1798	5	60	116	116	765	765	0	0	0	0	0	0	0	0	0	0	0	0	0	0	0	0	
197	1391597726	1389776983.sql	1391597726.sql	2014-02-05 10:55:26	1819	5	60	116	117	765	769	1	0	4	0	0	0	0	0	1	4	4	0	0	4	0	4	
198	1392020006	1391597726.sql	1392020006.sql	2014-02-10 08:13:26	1824	5	60	117	117	769	769	0	0	0	0	0	0	0	0	0	0	0	0	0	0	0	0	
199	1392070862	1392020006.sql	1392070862.sql	2014-02-10 22:21:02	1825	5	60	117	117	769	769	0	0	0	0	0	0	0	0	0	0	0	0	0	0	0	0	
200	1392128153	1392070862.sql	1392128153.sql	2014-02-11 14:15:53	1825	5	60	117	117	769	769	0	0	0	0	0	0	0	0	0	0	0	0	0	0	0	0	
201	1392137697	1392128153.sql	1392137697.sql	2014-02-11 16:54:57	1825	5	60	117	117	769	769	0	0	0	0	0	0	0	0	0	0	0	0	0	0	0	0	
202	1392375756	1392137697.sql	1392375756.sql	2014-02-14 11:02:36	1828	6	61	117	117	769	769	0	0	0	0	0	0	0	0	0	0	0	0	0	0	0	0	
203	1393245353	1392375756.sql	1393245353.sql	2014-02-24 12:35:53	1838	6	61	117	117	769	769	0	0	0	0	0	0	0	0	0	0	0	0	0	0	0	0	
204	1393343128	1393245353.sql	1393343128.sql	2014-02-25 15:45:28	1839	6	61	117	117	769	769	0	0	0	0	0	0	0	0	0	0	0	0	0	0	0	0	
205	1393343344	1393343128.sql	1393343344.sql	2014-02-25 15:49:04	1839	6	61	117	117	769	769	0	0	0	0	0	0	0	0	0	0	0	0	0	0	0	0	
206	1393343465	1393343344.sql	1393343465.sql	2014-02-25 15:51:05	1839	6	61	117	117	769	769	0	0	0	0	0	0	0	0	0	0	0	0	0	0	0	0	
207	1393605677	1393343465.sql	1393605677.sql	2014-02-28 16:41:17	1842	6	61	117	117	769	770	0	0	0	0	1	0	0	0	0	1	1	0	0	1	0	1	
208	1394691755	1393605677.sql	1394691755.sql	2014-03-13 06:22:35	1855	6	62	117	116	770	765	0	1	0	4	1	2	0	0	-1	-5	1	6	0	1	6	7	
209	1395554056	1394691755.sql	1395554056.sql	2014-03-23 05:54:16	1865	6	62	116	116	765	765	0	0	0	0	0	0	0	0	0	0	0	0	0	0	0	0	
210	1395856584	1395554056.sql	1395856584.sql	2014-03-26 17:56:24	1869	6	62	116	117	765	769	1	0	7	0	0	3	0	1	1	4	7	3	1	7	4	11	
211	1395936079	1395856584.sql	1395936079.sql	2014-03-27 16:01:19	1869	6	62	117	117	769	770	0	0	0	0	1	0	0	0	0	1	1	0	0	1	0	1	
212	1395939935	1395936079.sql	1395939935.sql	2014-03-27 17:05:35	1869	6	62	117	118	770	775	1	0	5	0	0	0	0	0	1	5	5	0	0	5	0	5	
213	1396286000	1395939935.sql	1396286000.sql	2014-03-31 17:13:20	1873	6	62	118	118	775	775	0	0	0	0	0	0	0	2	0	0	0	0	2	0	2	2	
214	1396979583	1396286000.sql	1396979583.sql	2014-04-08 17:53:03	1882	6	62	118	118	775	775	0	0	0	0	0	0	0	0	0	0	0	0	0	0	0	0	
215	1397308090	1396979583.sql	1397308090.sql	2014-04-12 13:08:10	1885	6	63	118	118	775	775	0	0	0	0	0	0	0	0	0	0	0	0	0	0	0	0	
216	1397469917	1397308090.sql	1397469917.sql	2014-04-14 10:05:17	1887	6	63	118	118	775	774	0	0	0	0	0	1	0	0	0	-1	0	1	0	0	1	1	
217	1398188490	1397469917.sql	1398188490.sql	2014-04-22 17:41:30	1896	6	63	118	118	774	774	0	0	0	0	0	0	0	0	0	0	0	0	0	0	0	0	
218	1399044672	1398188490.sql	1399044672.sql	2014-05-02 15:31:12	1905	6	63	118	118	774	774	0	0	0	0	0	0	0	0	0	0	0	0	0	0	0	0	
219	1400246535	1399044672.sql	1400246535.sql	2014-05-16 13:22:15	1919	6	64	118	118	774	777	0	0	0	0	3	0	0	0	0	3	3	0	0	3	0	3	
220	1400392535	1400246535.sql	1400392535.sql	2014-05-18 05:55:35	1921	6	64	118	119	777	780	1	0	6	0	0	3	0	0	1	3	6	3	0	6	3	9	
221	1400428557	1400392535.sql	1400428557.sql	2014-05-18 15:55:57	1921	6	64	119	119	780	780	0	0	0	0	1	1	0	0	0	0	1	1	0	1	1	2	
222	1400773550	1400428557.sql	1400773550.sql	2014-05-22 15:45:50	1925	6	64	119	119	780	780	0	0	0	0	0	0	0	0	0	0	0	0	0	0	0	0	
223	1401085474	1400773550.sql	1401085474.sql	2014-05-26 06:24:34	1929	6	64	119	119	780	780	0	0	0	0	0	0	1	0	0	0	0	0	1	0	1	1	
224	1403077915	1401085474.sql	1403077915.sql	2014-06-18 07:51:55	1952	6	65	119	119	780	780	0	0	0	0	0	0	0	0	0	0	0	0	0	0	0	0	
225	1403078370	1403077915.sql	1403078370.sql	2014-06-18 07:59:30	1952	6	65	119	119	780	783	0	0	0	0	3	0	0	0	0	3	3	0	0	3	0	3	
226	1403279827	1403078370.sql	1403279827.sql	2014-06-20 15:57:07	1954	6	65	119	119	783	780	0	0	0	0	1	4	0	0	0	-3	1	4	0	1	4	5	
227	1403323132	1403279827.sql	1403323132.sql	2014-06-21 03:58:52	1955	6	65	119	119	780	783	0	0	0	0	3	0	0	0	0	3	3	0	0	3	0	3	
228	1403895091	1403323132.sql	1403895091.sql	2014-06-27 18:51:31	1962	6	65	119	119	783	783	0	0	0	0	0	0	1	0	0	0	0	0	1	0	1	1	
229	1404240250	1403895091.sql	1404240250.sql	2014-07-01 18:44:10	1966	6	65	119	119	783	783	0	0	0	0	0	0	0	0	0	0	0	0	0	0	0	0	
230	1404244270	1404240250.sql	1404244270.sql	2014-07-01 19:51:10	1966	6	65	119	119	783	783	0	0	0	0	0	0	0	0	0	0	0	0	0	0	0	0	
231	1404248651	1404244270.sql	1404248651.sql	2014-07-01 21:04:11	1966	6	65	119	119	783	783	0	0	0	0	0	0	0	0	0	0	0	0	0	0	0	0	
232	1404249289	1404248651.sql	1404249289.sql	2014-07-01 21:14:49	1966	6	65	119	119	783	783	0	0	0	0	0	0	0	0	0	0	0	0	0	0	0	0	
233	1404315628	1404249289.sql	1404315628.sql	2014-07-02 15:40:28	1966	6	65	119	119	783	783	0	0	0	0	1	1	0	0	0	0	1	1	0	1	1	2	
234	1404727441	1404315628.sql	1404727441.sql	2014-07-07 10:04:01	1971	6	65	119	119	783	783	0	0	0	0	0	0	0	0	0	0	0	0	0	0	0	0	
235	1405436294	1404727441.sql	1405436294.sql	2014-07-15 14:58:14	1979	6	66	119	120	783	787	1	0	4	0	0	0	0	0	1	4	4	0	0	4	0	4	
236	1405518870	1405436294.sql	1405518870.sql	2014-07-16 13:54:30	1980	6	66	120	120	787	787	0	0	0	0	0	0	0	0	0	0	0	0	0	0	0	0	
237	1405537674	1405518870.sql	1405537674.sql	2014-07-16 19:07:54	1981	6	66	120	120	787	787	0	0	0	0	0	0	0	0	0	0	0	0	0	0	0	0	
238	1405800055	1405537674.sql	1405800055.sql	2014-07-19 20:00:55	1984	6	66	120	120	787	787	0	0	0	0	0	0	1	0	0	0	0	0	1	0	1	1	
239	1405800094	1405800055.sql	1405800094.sql	2014-07-19 20:01:34	1984	6	66	120	120	787	787	0	0	0	0	0	0	1	0	0	0	0	0	1	0	1	1	
240	1406065318	1405800094.sql	1406065318.sql	2014-07-22 21:41:58	1987	6	66	120	120	787	788	0	0	0	0	1	0	0	0	0	1	1	0	0	1	0	1	
241	1406478051	1406065318.sql	1406478051.sql	2014-07-27 16:20:51	1991	6	66	120	120	788	788	0	0	0	0	0	0	0	0	0	0	0	0	0	0	0	0	
242	1406934126	1406478051.sql	1406934126.sql	2014-08-01 23:02:06	1997	6	66	120	120	788	788	0	0	0	0	0	0	0	0	0	0	0	0	0	0	0	0	
243	1406936401	1406934126.sql	1406936401.sql	2014-08-01 23:40:01	1997	6	66	120	120	788	788	0	0	0	0	0	0	0	0	0	0	0	0	0	0	0	0	
244	1406936984	1406936401.sql	1406936984.sql	2014-08-01 23:49:44	1997	6	66	120	120	788	788	0	0	0	0	0	0	0	0	0	0	0	0	0	0	0	0	
245	1406937377	1406936984.sql	1406937377.sql	2014-08-01 23:56:17	1997	6	66	120	120	788	788	0	0	0	0	0	0	0	0	0	0	0	0	0	0	0	0	
246	1406990617	1406937377.sql	1406990617.sql	2014-08-02 14:43:37	1997	6	66	120	120	788	788	0	0	0	0	0	0	1	0	0	0	0	0	1	0	1	1	
247	1407021136	1406990617.sql	1407021136.sql	2014-08-02 23:12:16	1998	6	66	120	120	788	788	0	0	0	0	0	0	0	0	0	0	0	0	0	0	0	0	
248	1407145614	1407021136.sql	1407145614.sql	2014-08-04 09:46:54	1999	6	66	120	120	788	788	0	0	0	0	0	0	0	0	0	0	0	0	0	0	0	0	
249	1407417846	1407145614.sql	1407417846.sql	2014-08-07 13:24:06	2002	6	66	120	120	788	788	1	1	6	6	0	0	0	0	0	0	6	6	0	6	6	12	
250	1407418090	1407417846.sql	1407418090.sql	2014-08-07 13:28:10	2002	6	66	120	120	788	788	1	1	6	6	0	0	0	0	0	0	6	6	0	6	6	12	
251	1407712184	1407418090.sql	1407712184.sql	2014-08-10 23:09:44	2006	6	66	120	120	788	788	0	0	0	0	0	0	0	0	0	0	0	0	0	0	0	0	
252	1407783457	1407712184.sql	1407783457.sql	2014-08-11 18:57:37	2007	6	67	120	120	788	788	0	0	0	0	0	0	0	0	0	0	0	0	0	0	0	0	
253	1408029510	1407783457.sql	1408029510.sql	2014-08-14 15:18:30	2009	6	67	120	120	788	788	3	3	18	18	4	4	0	0	0	0	22	22	0	22	22	44	
254	1408232563	1408029510.sql	1408232563.sql	2014-08-16 23:42:43	2012	6	67	120	120	788	788	0	0	0	0	2	2	0	0	0	0	2	2	0	2	2	4	
255	1408373437	1408232563.sql	1408373437.sql	2014-08-18 14:50:37	2013	6	67	120	120	788	788	0	0	0	0	0	0	0	0	0	0	0	0	0	0	0	0	
256	1408387722	1408373437.sql	1408387722.sql	2014-08-18 18:48:42	2014	6	67	120	120	788	788	0	0	0	0	0	0	0	0	0	0	0	0	0	0	0	0	
257	1408721207	1408387722.sql	1408721207.sql	2014-08-22 15:26:47	2017	6	67	120	120	788	788	0	0	0	0	0	0	0	1	0	0	0	0	1	0	1	1	
258	1408758781	1408721207.sql	1408758781.sql	2014-08-23 01:53:01	2018	6	67	120	120	788	788	0	0	0	0	0	0	0	1	0	0	0	0	1	0	1	1	
259	1409145084	1408758781.sql	1409145084.sql	2014-08-27 13:11:24	2022	6	67	120	120	788	788	0	0	0	0	1	1	0	0	0	0	1	1	0	1	1	2	
260	1409153990	1409145084.sql	1409153990.sql	2014-08-27 15:39:50	2022	6	67	120	120	788	789	0	0	0	0	3	2	0	0	0	1	3	2	0	3	2	5	
261	1409229338	1409153990.sql	1409229338.sql	2014-08-28 12:35:38	2023	6	67	120	120	789	788	0	0	0	0	0	1	1	0	0	-1	0	1	1	0	2	2	
262	1409861731	1409229338.sql	1409861731.sql	2014-09-04 20:15:31	2031	6	67	120	120	788	788	0	0	0	0	0	0	0	0	0	0	0	0	0	0	0	0	
263	1410888915	1409861731.sql	1410888915.sql	2014-09-16 17:35:15	2043	6	68	120	120	788	788	0	0	0	0	0	0	0	0	0	0	0	0	0	0	0	0	
264	1410954794	1410888915.sql	1410954794.sql	2014-09-17 11:53:14	2043	6	68	120	121	788	794	1	0	6	0	0	0	0	0	1	6	6	0	0	6	0	6	
265	1410976443	1410954794.sql	1410976443.sql	2014-09-17 17:54:03	2044	6	68	121	122	794	798	1	0	4	0	0	0	0	0	1	4	4	0	0	4	0	4	
266	1411061280	1410976443.sql	1411061280.sql	2014-09-18 17:28:00	2045	6	68	122	122	798	798	0	0	0	0	1	1	1	0	0	0	1	1	1	1	2	3	
267	1411081682	1411061280.sql	1411081682.sql	2014-09-18 23:08:02	2045	6	68	122	122	798	798	0	0	0	0	0	0	0	0	0	0	0	0	0	0	0	0	
268	1411106252	1411081682.sql	1411106252.sql	2014-09-19 05:57:32	2045	6	68	122	122	798	797	0	0	0	0	0	1	0	0	0	-1	0	1	0	0	1	1	
269	1411106282	1411106252.sql	1411106282.sql	2014-09-19 05:58:02	2045	6	68	122	122	797	797	0	0	0	0	0	0	0	0	0	0	0	0	0	0	0	0	
270	1411287479	1411106282.sql	1411287479.sql	2014-09-21 08:17:59	2047	6	68	122	122	797	795	0	0	0	0	0	2	0	0	0	-2	0	2	0	0	2	2	
271	1411554369	1411287479.sql	1411554369.sql	2014-09-24 10:26:09	2050	6	68	122	122	795	796	0	0	0	0	1	0	0	0	0	1	1	0	0	1	0	1	
272	1411581449	1411554369.sql	1411581449.sql	2014-09-24 17:57:29	2051	6	68	122	121	796	793	0	1	0	3	2	2	0	0	-1	-3	2	5	0	2	5	7	
273	1411647742	1411581449.sql	1411647742.sql	2014-09-25 12:22:22	2051	6	68	121	121	793	793	0	0	0	0	0	0	0	0	0	0	0	0	0	0	0	0	
274	1411656748	1411647742.sql	1411656748.sql	2014-09-25 14:52:28	2051	6	68	121	121	793	793	0	0	0	0	0	0	0	0	0	0	0	0	0	0	0	0	
275	1411659316	1411656748.sql	1411659316.sql	2014-09-25 15:35:16	2051	6	68	121	121	793	793	0	0	0	0	0	0	0	0	0	0	0	0	0	0	0	0	
276	1411849118	1411659316.sql	1411849118.sql	2014-09-27 20:18:38	2054	6	68	121	121	793	793	0	0	0	0	0	0	0	0	0	0	0	0	0	0	0	0	
277	1411857174	1411849118.sql	1411857174.sql	2014-09-27 22:32:54	2054	6	68	121	121	793	795	0	0	0	0	2	0	0	0	0	2	2	0	0	2	0	2	
278	1412007336	1411857174.sql	1412007336.sql	2014-09-29 16:15:36	2055	6	68	121	121	795	795	0	0	0	0	0	0	0	0	0	0	0	0	0	0	0	0	
279	1413036858	1412007336.sql	1413036858.sql	2014-10-11 14:14:18	2067	6	68	121	121	795	795	0	0	0	0	0	0	0	0	0	0	0	0	0	0	0	0	
280	1413136833	1413036858.sql	1413136833.sql	2014-10-12 18:00:33	2069	6	69	121	121	795	795	0	0	0	0	0	0	0	0	0	0	0	0	0	0	0	0	
281	1413392480	1413136833.sql	1413392480.sql	2014-10-15 17:01:20	2071	6	69	121	121	795	795	0	0	0	0	0	0	0	0	0	0	0	0	0	0	0	0	
282	1413432235	1413392480.sql	1413432235.sql	2014-10-16 04:03:55	2072	6	69	121	121	795	795	0	0	0	0	0	0	0	0	0	0	0	0	0	0	0	0	
283	1413463153	1413432235.sql	1413463153.sql	2014-10-16 12:39:13	2072	6	69	121	121	795	795	0	0	0	0	0	0	0	0	0	0	0	0	0	0	0	0	
284	1413479895	1413463153.sql	1413479895.sql	2014-10-16 17:18:15	2072	6	69	121	123	795	807	2	0	12	0	0	0	0	0	2	12	12	0	0	12	0	12	
285	1413533746	1413479895.sql	1413533746.sql	2014-10-17 08:15:46	2073	6	69	123	123	807	806	0	0	0	0	0	1	0	0	0	-1	0	1	0	0	1	1	
286	1413533989	1413533746.sql	1413533989.sql	2014-10-17 08:19:49	2073	6	69	123	123	806	806	0	0	0	0	0	0	0	0	0	0	0	0	0	0	0	0	
287	1413555526	1413533989.sql	1413555526.sql	2014-10-17 14:18:46	2073	6	69	123	123	806	806	0	0	0	0	0	0	0	0	0	0	0	0	0	0	0	0	
288	1413562048	1413555526.sql	1413562048.sql	2014-10-17 16:07:28	2073	6	69	123	123	806	807	0	0	0	0	1	0	0	0	0	1	1	0	0	1	0	1	
289	1413566835	1413562048.sql	1413566835.sql	2014-10-17 17:27:15	2074	6	69	123	123	807	807	0	0	0	0	1	1	1	0	0	0	1	1	1	1	2	3	
290	1413566975	1413566835.sql	1413566975.sql	2014-10-17 17:29:35	2074	6	69	123	123	807	807	0	0	0	0	0	0	0	0	0	0	0	0	0	0	0	0	
291	1413788845	1413566975.sql	1413788845.sql	2014-10-20 07:07:25	2076	6	69	123	123	807	807	0	0	0	0	0	0	0	0	0	0	0	0	0	0	0	0	
292	1413808183	1413788845.sql	1413808183.sql	2014-10-20 12:29:43	2076	6	69	123	123	807	807	0	0	0	0	0	0	0	0	0	0	0	0	0	0	0	0	
293	1414176993	1413808183.sql	1414176993.sql	2014-10-24 18:56:33	2081	6	69	123	123	807	807	0	0	0	0	0	0	0	0	0	0	0	0	0	0	0	0	
294	1414404572	1414176993.sql	1414404572.sql	2014-10-27 10:09:32	2083	6	69	123	123	807	807	0	0	0	0	0	0	0	0	0	0	0	0	0	0	0	0	
295	1415554254	1414404572.sql	1415554254.sql	2014-11-09 17:30:54	2097	6	69	123	123	807	807	0	0	0	0	0	0	0	0	0	0	0	0	0	0	0	0	
296	1415802652	1415554254.sql	1415802652.sql	2014-11-12 14:30:52	2099	6	70	123	123	807	807	0	0	0	0	0	0	0	0	0	0	0	0	0	0	0	0	
297	1416408693	1415802652.sql	1416408693.sql	2014-11-19 14:51:33	2106	6	70	123	124	807	811	1	0	4	0	1	1	0	0	1	4	5	1	0	5	1	6	
298	1416434926	1416408693.sql	1416434926.sql	2014-11-19 22:08:46	2107	6	70	124	124	811	811	0	0	0	0	0	0	0	0	0	0	0	0	0	0	0	0	
299	1416450388	1416434926.sql	1416450388.sql	2014-11-20 02:26:28	2107	6	70	124	124	811	811	0	0	0	0	0	0	0	0	0	0	0	0	0	0	0	0	
300	1416769792	1416450388.sql	1416769792.sql	2014-11-23 19:09:52	2111	6	70	124	124	811	811	0	0	0	0	2	2	0	0	0	0	2	2	0	2	2	4	
301	1416819071	1416769792.sql	1416819071.sql	2014-11-24 08:51:11	2111	6	70	124	124	811	811	0	0	0	0	0	0	0	0	0	0	0	0	0	0	0	0	
302	1416821623	1416819071.sql	1416821623.sql	2014-11-24 09:33:43	2111	6	70	124	124	811	811	0	0	0	0	0	0	0	0	0	0	0	0	0	0	0	0	
303	1416824246	1416821623.sql	1416824246.sql	2014-11-24 10:17:26	2111	6	70	124	124	811	811	0	0	0	0	0	0	0	0	0	0	0	0	0	0	0	0	
304	1416895950	1416824246.sql	1416895950.sql	2014-11-25 06:12:30	2112	6	70	124	124	811	811	0	0	0	0	0	0	0	0	0	0	0	0	0	0	0	0	
305	1417118794	1416895950.sql	1417118794.sql	2014-11-27 20:06:34	2115	6	70	124	124	811	811	0	0	0	0	0	0	0	0	0	0	0	0	0	0	0	0	
306	1417630732	1417118794.sql	1417630732.sql	2014-12-03 18:18:52	2121	6	70	124	124	811	811	0	0	0	0	0	0	0	0	0	0	0	0	0	0	0	0	
307	1417756156	1417630732.sql	1417756156.sql	2014-12-05 05:09:16	2122	6	70	124	124	811	811	0	0	0	0	0	0	0	0	0	0	0	0	0	0	0	0	
308	1417756676	1417756156.sql	1417756676.sql	2014-12-05 05:17:56	2122	6	70	124	124	811	811	0	0	0	0	0	0	0	0	0	0	0	0	0	0	0	0	
309	1422783860	1417756676.sql	1422783860.sql	2015-02-01 09:44:20	2180	6	72	124	124	811	811	0	0	0	0	0	0	0	0	0	0	0	0	0	0	0	0	
310	1427887069	1422783860.sql	1427887069.sql	2015-04-01 11:17:49	2239	7	74	124	124	811	811	0	0	0	0	0	0	1	0	0	0	0	0	1	0	1	1	
311	1429466267	1427887069.sql	1429466267.sql	2015-04-19 17:57:47	2258	7	75	124	123	811	758	0	1	0	53	0	0	0	0	-1	-53	0	53	0	0	53	53	
312	1429957006	1429466267.sql	1429957006.sql	2015-04-25 10:16:46	2263	7	75	123	123	758	758	0	0	0	0	0	0	0	0	0	0	0	0	0	0	0	0	
313	1430199263	1429957006.sql	1430199263.sql	2015-04-28 05:34:23	2266	7	75	123	123	758	758	0	0	0	0	0	0	0	0	0	0	0	0	0	0	0	0	
314	1432308369	1430199263.sql	1432308369.sql	2015-05-22 15:26:09	2290	7	76	123	123	758	758	0	0	0	0	0	0	0	0	0	0	0	0	0	0	0	0	
315	1432738625	1432308369.sql	1432738625.sql	2015-05-27 14:57:05	2295	7	76	123	123	758	758	0	0	0	0	0	0	0	0	0	0	0	0	0	0	0	0	
316	1432988149	1432738625.sql	1432988149.sql	2015-05-30 12:15:49	2298	7	76	123	123	758	758	0	0	0	0	0	0	0	0	0	0	0	0	0	0	0	0	
317	1433921246	1432988149.sql	1433921246.sql	2015-06-10 07:27:26	2309	7	76	123	123	758	758	0	0	0	0	0	0	0	0	0	0	0	0	0	0	0	0	
318	1435325755	1433921246.sql	1435325755.sql	2015-06-26 13:35:55	2325	7	77	123	123	758	759	0	0	0	0	1	0	1	0	0	1	1	0	1	1	1	2	
319	1436077307	1435325755.sql	1436077307.sql	2015-07-05 06:21:47	2334	7	77	123	123	759	758	0	0	0	0	0	1	0	0	0	-1	0	1	0	0	1	1	
320	1436355915	1436077307.sql	1436355915.sql	2015-07-08 11:45:15	2337	7	77	123	124	758	759	1	0	3	0	0	2	0	0	1	1	3	2	0	3	2	5	
321	1436461332	1436355915.sql	1436461332.sql	2015-07-09 17:02:12	2338	7	77	124	125	759	767	1	0	8	0	0	0	0	0	1	8	8	0	0	8	0	8	
322	1437112721	1436461332.sql	1437112721.sql	2015-07-17 05:58:41	2346	7	78	125	125	767	767	0	0	0	0	0	0	1	0	0	0	0	0	1	0	1	1	
323	1437427926	1437112721.sql	1437427926.sql	2015-07-20 21:32:06	2350	7	78	125	125	767	767	0	0	0	0	0	0	0	0	0	0	0	0	0	0	0	0	
324	1437820588	1437427926.sql	1437820588.sql	2015-07-25 10:36:28	2354	7	78	125	125	767	767	0	0	0	0	0	0	0	0	0	0	0	0	0	0	0	0	
325	1437996162	1437820588.sql	1437996162.sql	2015-07-27 11:22:42	2356	7	78	125	125	767	767	0	0	0	0	0	0	0	0	0	0	0	0	0	0	0	0	
326	1438187254	1437996162.sql	1438187254.sql	2015-07-29 16:27:34	2358	7	78	125	125	767	767	0	0	0	0	2	2	0	0	0	0	2	2	0	2	2	4	
327	1438647449	1438187254.sql	1438647449.sql	2015-08-04 00:17:29	2364	7	78	125	124	767	765	0	1	0	2	0	0	0	0	-1	-2	0	2	0	0	2	2	
328	1439546472	1438647449.sql	1439546472.sql	2015-08-14 10:01:12	2374	7	79	124	124	765	765	0	0	0	0	0	0	0	0	0	0	0	0	0	0	0	0	
329	1439761340	1439546472.sql	1439761340.sql	2015-08-16 21:42:20	2377	7	79	124	124	765	765	0	0	0	0	0	0	0	0	0	0	0	0	0	0	0	0	
330	1439812208	1439761340.sql	1439812208.sql	2015-08-17 11:50:08	2377	7	79	124	124	765	765	0	0	0	0	0	0	0	0	0	0	0	0	0	0	0	0	
331	1439817207	1439812208.sql	1439817207.sql	2015-08-17 13:13:27	2377	7	79	124	124	765	765	0	0	0	0	0	0	0	0	0	0	0	0	0	0	0	0	
332	1439819649	1439817207.sql	1439819649.sql	2015-08-17 13:54:09	2377	7	79	124	124	765	765	0	0	0	0	0	0	0	0	0	0	0	0	0	0	0	0	
333	1439821707	1439819649.sql	1439821707.sql	2015-08-17 14:28:27	2377	7	79	124	124	765	765	0	0	0	0	0	0	0	0	0	0	0	0	0	0	0	0	
334	1439896854	1439821707.sql	1439896854.sql	2015-08-18 11:20:54	2378	7	79	124	124	765	765	0	0	0	0	0	0	0	0	0	0	0	0	0	0	0	0	
335	1440928076	1439896854.sql	1440928076.sql	2015-08-30 09:47:56	2390	7	79	124	124	765	765	0	0	0	0	0	0	0	0	0	0	0	0	0	0	0	0	
336	1441297562	1440928076.sql	1441297562.sql	2015-09-03 16:26:02	2394	7	79	124	124	765	765	0	0	0	0	0	0	0	0	0	0	0	0	0	0	0	0	
337	1442307004	1441297562.sql	1442307004.sql	2015-09-15 08:50:04	2406	7	80	124	125	765	774	1	0	9	0	0	0	0	0	1	9	9	0	0	9	0	9	
338	1442313928	1442307004.sql	1442313928.sql	2015-09-15 10:45:28	2406	7	80	125	125	774	774	0	0	0	0	0	0	0	0	0	0	0	0	0	0	0	0	
339	1442340485	1442313928.sql	1442340485.sql	2015-09-15 18:08:05	2407	7	80	125	125	774	773	0	0	0	0	0	1	0	0	0	-1	0	1	0	0	1	1	
340	1442405080	1442340485.sql	1442405080.sql	2015-09-16 12:04:40	2407	7	80	125	125	773	773	0	0	0	0	0	0	0	0	0	0	0	0	0	0	0	0	
341	1442648027	1442405080.sql	1442648027.sql	2015-09-19 07:33:47	2410	7	80	125	126	773	776	1	0	3	0	0	0	0	0	1	3	3	0	0	3	0	3	
342	1443116357	1442648027.sql	1443116357.sql	2015-09-24 17:39:17	2416	7	80	126	126	776	776	0	0	0	0	0	0	0	0	0	0	0	0	0	0	0	0	
343	1444134102	1443116357.sql	1444134102.sql	2015-10-06 12:21:42	2427	7	80	126	126	776	776	0	0	0	0	0	0	0	0	0	0	0	0	0	0	0	0	
344	1444226874	1444134102.sql	1444226874.sql	2015-10-07 14:07:54	2428	7	80	126	126	776	776	0	0	0	0	0	0	0	0	0	0	0	0	0	0	0	0	
345	1444235822	1444226874.sql	1444235822.sql	2015-10-07 16:37:02	2428	7	80	126	126	776	776	0	0	0	0	0	0	0	0	0	0	0	0	0	0	0	0	
346	1444668844	1444235822.sql	1444668844.sql	2015-10-12 16:54:04	2433	7	81	126	126	776	776	0	0	0	0	0	0	0	0	0	0	0	0	0	0	0	0	
347	1444670767	1444668844.sql	1444670767.sql	2015-10-12 17:26:07	2434	7	81	126	126	776	776	0	0	0	0	2	2	0	0	0	0	2	2	0	2	2	4	
348	1444801713	1444670767.sql	1444801713.sql	2015-10-14 05:48:33	2435	7	81	126	126	776	776	0	0	0	0	0	0	0	0	0	0	0	0	0	0	0	0	
349	1444801786	1444801713.sql	1444801786.sql	2015-10-14 05:49:46	2435	7	81	126	126	776	776	0	0	0	0	0	0	0	0	0	0	0	0	0	0	0	0	
350	1446405882	1444801786.sql	1446405882.sql	2015-11-01 19:24:42	2454	7	81	126	126	776	776	0	0	0	0	0	0	0	0	0	0	0	0	0	0	0	0	
351	1448001656	1446405882.sql	1448001656.sql	2015-11-20 06:40:56	2472	7	82	126	126	776	777	0	0	0	0	1	0	0	0	0	1	1	0	0	1	0	1	
352	1449752995	1448001656.sql	1449752995.sql	2015-12-10 13:09:55	2492	7	82	126	126	777	777	0	0	0	0	0	0	0	0	0	0	0	0	0	0	0	0	
353	1449761975	1449752995.sql	1449761975.sql	2015-12-10 15:39:35	2492	7	82	126	126	777	777	0	0	0	0	0	0	0	0	0	0	0	0	0	0	0	0	
354	1450877126	1449761975.sql	1450877126.sql	2015-12-23 13:25:26	2505	7	83	126	126	777	777	0	0	0	0	0	0	0	0	0	0	0	0	0	0	0	0	
355	1450931907	1450877126.sql	1450931907.sql	2015-12-24 04:38:27	2506	7	83	126	126	777	777	0	0	0	0	0	0	0	0	0	0	0	0	0	0	0	0	
356	1451018790	1450931907.sql	1451018790.sql	2015-12-25 04:46:30	2507	7	83	126	126	777	777	0	0	0	0	0	0	0	0	0	0	0	0	0	0	0	0	
357	1451277757	1451018790.sql	1451277757.sql	2015-12-28 04:42:37	2510	7	83	126	126	777	777	0	0	0	0	0	0	0	0	0	0	0	0	0	0	0	0	
358	1451541199	1451277757.sql	1451541199.sql	2015-12-31 05:53:19	2513	7	83	126	126	777	777	0	0	0	0	0	0	0	0	0	0	0	0	0	0	0	0	
359	1451892196	1451541199.sql	1451892196.sql	2016-01-04 07:23:16	2517	7	83	126	126	777	777	0	0	0	0	0	0	1	0	0	0	0	0	1	0	1	1	
360	1452153046	1451892196.sql	1452153046.sql	2016-01-07 07:50:46	2520	7	83	126	126	777	777	0	0	0	0	0	0	0	0	0	0	0	0	0	0	0	0	
361	1452154367	1452153046.sql	1452154367.sql	2016-01-07 08:12:47	2520	7	83	126	126	777	777	0	0	0	0	0	0	0	0	0	0	0	0	0	0	0	0	
362	1452164687	1452154367.sql	1452164687.sql	2016-01-07 11:04:47	2520	7	83	126	126	777	777	0	0	0	0	0	0	0	0	0	0	0	0	0	0	0	0	
363	1452243929	1452164687.sql	1452243929.sql	2016-01-08 09:05:29	2521	7	83	126	126	777	777	0	0	0	0	0	0	0	0	0	0	0	0	0	0	0	0	
364	1452591705	1452243929.sql	1452591705.sql	2016-01-12 09:41:45	2525	7	84	126	126	777	777	0	0	0	0	0	0	0	0	0	0	0	0	0	0	0	0	
365	1452697909	1452591705.sql	1452697909.sql	2016-01-13 15:11:49	2526	7	84	126	126	777	777	0	0	0	0	0	0	0	0	0	0	0	0	0	0	0	0	
366	1452703730	1452697909.sql	1452703730.sql	2016-01-13 16:48:50	2526	7	84	126	126	777	777	0	0	0	0	0	0	0	0	0	0	0	0	0	0	0	0	
367	1452714658	1452703730.sql	1452714658.sql	2016-01-13 19:50:58	2527	7	84	126	126	777	777	0	0	0	0	0	0	0	0	0	0	0	0	0	0	0	0	
368	1452714773	1452714658.sql	1452714773.sql	2016-01-13 19:52:53	2527	7	84	126	126	777	777	0	0	0	0	0	0	0	0	0	0	0	0	0	0	0	0	
369	1452760697	1452714773.sql	1452760697.sql	2016-01-14 08:38:17	2527	7	84	126	126	777	777	0	0	0	0	0	0	0	0	0	0	0	0	0	0	0	0	
370	1452760712	1452760697.sql	1452760712.sql	2016-01-14 08:38:32	2527	7	84	126	126	777	777	0	0	0	0	0	0	0	0	0	0	0	0	0	0	0	0	
371	1452926633	1452760712.sql	1452926633.sql	2016-01-16 06:43:53	2529	7	84	126	126	777	777	0	0	0	0	0	0	0	0	0	0	0	0	0	0	0	0	
372	1453106845	1452926633.sql	1453106845.sql	2016-01-18 08:47:25	2531	7	84	126	126	777	777	0	0	0	0	0	0	1	0	0	0	0	0	1	0	1	1	
373	1453304865	1453106845.sql	1453304865.sql	2016-01-20 15:47:45	2533	7	84	126	126	777	777	0	0	0	0	0	0	0	0	0	0	0	0	0	0	0	0	
374	1453384386	1453304865.sql	1453384386.sql	2016-01-21 13:53:06	2534	7	84	126	126	777	777	0	0	0	0	0	0	0	0	0	0	0	0	0	0	0	0	
375	1453672797	1453384386.sql	1453672797.sql	2016-01-24 21:59:57	2538	7	84	126	126	777	777	0	0	0	0	0	0	0	0	0	0	0	0	0	0	0	0	
376	1455798046	1453672797.sql	1455798046.sql	2016-02-18 12:20:46	2562	8	85	126	126	777	778	0	0	0	0	1	0	0	0	0	1	1	0	0	1	0	1	
377	1457695428	1455798046.sql	1457695428.sql	2016-03-11 11:23:48	2584	8	85	126	126	778	780	0	0	0	0	2	0	0	0	0	2	2	0	0	2	0	2	
378	1457855729	1457695428.sql	1457855729.sql	2016-03-13 07:55:29	2586	8	86	126	125	780	776	0	1	0	4	0	0	0	0	-1	-4	0	4	0	0	4	4	
379	1458209766	1457855729.sql	1458209766.sql	2016-03-17 10:16:06	2590	8	86	125	125	776	776	0	0	0	0	0	0	0	0	0	0	0	0	0	0	0	0	
380	1459007941	1458209766.sql	1459007941.sql	2016-03-26 15:59:01	2599	8	86	125	126	776	781	1	0	5	0	0	0	0	0	1	5	5	0	0	5	0	5	
381	1459012743	1459007941.sql	1459012743.sql	2016-03-26 17:19:03	2599	8	86	126	126	781	781	0	0	0	0	0	0	0	0	0	0	0	0	0	0	0	0	
382	1459100187	1459012743.sql	1459100187.sql	2016-03-27 17:36:27	2601	8	86	126	126	781	782	0	0	0	0	1	0	0	0	0	1	1	0	0	1	0	1	
383	1459187226	1459100187.sql	1459187226.sql	2016-03-28 17:47:06	2602	8	86	126	126	782	782	0	0	0	0	1	1	0	0	0	0	1	1	0	1	1	2	
384	1460645191	1459187226.sql	1460645191.sql	2016-04-14 14:46:31	2618	8	87	126	126	782	782	0	0	0	0	0	0	1	0	0	0	0	0	1	0	1	1	
385	1460918013	1460645191.sql	1460918013.sql	2016-04-17 18:33:33	2622	8	87	126	126	782	782	0	0	0	0	0	0	1	0	0	0	0	0	1	0	1	1	
386	1462427291	1460918013.sql	1462427291.sql	2016-05-05 05:48:11	2639	8	87	126	126	782	784	0	0	0	0	2	0	0	0	0	2	2	0	0	2	0	2	
387	1463026374	1462427291.sql	1463026374.sql	2016-05-12 04:12:54	2646	8	88	126	126	784	784	0	0	0	0	0	0	0	0	0	0	0	0	0	0	0	0	
388	1463295909	1463026374.sql	1463295909.sql	2016-05-15 07:05:09	2649	8	88	126	129	784	797	3	0	13	0	0	0	0	0	3	13	13	0	0	13	0	13	
389	1464885264	1463295909.sql	1464885264.sql	2016-06-02 16:34:24	2667	8	88	129	130	797	802	1	0	5	0	0	0	3	0	1	5	5	0	3	5	3	8	
390	1465234973	1464885264.sql	1465234973.sql	2016-06-06 17:42:53	2672	8	88	130	130	802	802	0	0	0	0	0	0	0	0	0	0	0	0	0	0	0	0	
391	1465356729	1465234973.sql	1465356729.sql	2016-06-08 03:32:09	2673	8	88	130	129	802	797	0	1	0	5	0	0	4	0	-1	-5	0	5	4	0	9	9	
392	1465390980	1465356729.sql	1465390980.sql	2016-06-08 13:03:00	2673	8	88	129	130	797	802	1	0	5	0	0	0	4	0	1	5	5	0	4	5	4	9	
393	1465449156	1465390980.sql	1465449156.sql	2016-06-09 05:12:36	2674	8	88	130	130	802	802	0	0	0	0	0	0	1	0	0	0	0	0	1	0	1	1	
394	1465475363	1465449156.sql	1465475363.sql	2016-06-09 12:29:23	2674	8	88	130	130	802	802	0	0	0	0	0	0	0	0	0	0	0	0	0	0	0	0	
395	1465960402	1465475363.sql	1465960402.sql	2016-06-15 03:13:22	2680	8	89	130	130	802	802	0	0	0	0	0	0	0	0	0	0	0	0	0	0	0	0	
396	1465963816	1465960402.sql	1465963816.sql	2016-06-15 04:10:16	2680	8	89	130	130	802	802	0	0	0	0	0	0	0	0	0	0	0	0	0	0	0	0	
397	1465963997	1465963816.sql	1465963997.sql	2016-06-15 04:13:17	2680	8	89	130	130	802	802	0	0	0	0	0	0	0	0	0	0	0	0	0	0	0	0	
398	1465964163	1465963997.sql	1465964163.sql	2016-06-15 04:16:03	2680	8	89	130	130	802	802	0	0	0	0	0	0	0	0	0	0	0	0	0	0	0	0	
399	1465968943	1465964163.sql	1465968943.sql	2016-06-15 05:35:43	2680	8	89	130	130	802	802	0	0	0	0	0	0	0	0	0	0	0	0	0	0	0	0	
400	1466496949	1465968943.sql	1466496949.sql	2016-06-21 08:15:49	2686	8	89	130	130	802	803	0	0	0	0	1	0	0	0	0	1	1	0	0	1	0	1	
401	1466503079	1466496949.sql	1466503079.sql	2016-06-21 09:57:59	2686	8	89	130	130	803	803	0	0	0	0	0	0	0	0	0	0	0	0	0	0	0	0	
402	1466681771	1466503079.sql	1466681771.sql	2016-06-23 11:36:11	2688	8	89	130	130	803	803	0	0	0	0	0	0	0	0	0	0	0	0	0	0	0	0	
403	1466684582	1466681771.sql	1466684582.sql	2016-06-23 12:23:02	2688	8	89	130	130	803	803	0	0	0	0	0	0	0	0	0	0	0	0	0	0	0	0	
404	1466705183	1466684582.sql	1466705183.sql	2016-06-23 18:06:23	2689	8	89	130	131	803	814	1	0	11	0	0	0	0	0	1	11	11	0	0	11	0	11	
405	1466867937	1466705183.sql	1466867937.sql	2016-06-25 15:18:57	2690	8	89	131	131	814	814	0	0	0	0	0	0	0	0	0	0	0	0	0	0	0	0	
406	1466944942	1466867937.sql	1466944942.sql	2016-06-26 12:42:22	2691	8	89	131	131	814	814	0	0	0	0	0	0	0	0	0	0	0	0	0	0	0	0	
407	1467014813	1466944942.sql	1467014813.sql	2016-06-27 08:06:53	2692	8	89	131	131	814	815	0	0	0	0	1	0	0	0	0	1	1	0	0	1	0	1	
408	1467449990	1467014813.sql	1467449990.sql	2016-07-02 08:59:50	2697	8	89	131	128	815	802	0	3	0	13	0	0	0	0	-3	-13	0	13	0	0	13	13	
409	1467563934	1467449990.sql	1467563934.sql	2016-07-03 16:38:54	2698	8	89	128	131	802	815	3	0	13	0	0	0	0	0	3	13	13	0	0	13	0	13	
410	1467610068	1467563934.sql	1467610068.sql	2016-07-04 05:27:48	2699	8	89	131	128	815	802	0	3	0	13	0	0	0	0	-3	-13	0	13	0	0	13	13	
411	1467705148	1467610068.sql	1467705148.sql	2016-07-05 07:52:28	2700	8	89	128	131	802	815	3	0	13	0	0	0	0	0	3	13	13	0	0	13	0	13	
412	1467707864	1467705148.sql	1467707864.sql	2016-07-05 08:37:44	2700	8	89	131	131	815	815	0	0	0	0	0	0	0	0	0	0	0	0	0	0	0	0	
413	1467718385	1467707864.sql	1467718385.sql	2016-07-05 11:33:05	2700	8	89	131	131	815	815	0	0	0	0	0	0	0	0	0	0	0	0	0	0	0	0	
414	1467879621	1467718385.sql	1467879621.sql	2016-07-07 08:20:21	2702	8	89	131	131	815	816	0	0	0	0	1	0	0	0	0	1	1	0	0	1	0	1	
415	1468324632	1467879621.sql	1468324632.sql	2016-07-12 11:57:12	2707	8	90	131	131	816	816	0	0	0	0	0	0	0	1	0	0	0	0	1	0	1	1	
416	1468419872	1468324632.sql	1468419872.sql	2016-07-13 14:24:32	2708	8	90	131	131	816	817	0	0	0	0	1	0	0	0	0	1	1	0	0	1	0	1	
417	1468435500	1468419872.sql	1468435500.sql	2016-07-13 18:45:00	2709	8	90	131	131	817	817	0	0	0	0	0	0	0	0	0	0	0	0	0	0	0	0	
418	1468556560	1468435500.sql	1468556560.sql	2016-07-15 04:22:40	2710	8	90	131	131	817	817	0	0	0	0	0	0	1	0	0	0	0	0	1	0	1	1	
419	1468903507	1468556560.sql	1468903507.sql	2016-07-19 04:45:07	2714	8	90	131	131	817	817	0	0	0	0	0	0	0	0	0	0	0	0	0	0	0	0	
420	1469557336	1468903507.sql	1469557336.sql	2016-07-26 18:22:16	2722	8	90	131	132	817	822	1	0	5	0	0	0	0	0	1	5	5	0	0	5	0	5	
421	1469631446	1469557336.sql	1469631446.sql	2016-07-27 14:57:26	2722	8	90	132	132	822	821	0	0	0	0	0	1	1	0	0	-1	0	1	1	0	2	2	
422	1469637561	1469631446.sql	1469637561.sql	2016-07-27 16:39:21	2722	8	90	132	132	821	821	0	0	0	0	0	0	0	0	0	0	0	0	0	0	0	0	
423	1472198462	1469637561.sql	1472198462.sql	2016-08-26 08:01:02	2752	8	91	132	134	821	829	2	0	8	0	0	0	0	0	2	8	8	0	0	8	0	8	
424	1475192397	1472198462.sql	1475192397.sql	2016-09-29 23:39:57	2787	8	92	134	131	829	815	0	3	0	12	0	2	2	0	-3	-14	0	14	2	0	16	16	
425	1478094782	1475192397.sql	1478094782.sql	2016-11-02 13:53:02	2820	8	93	131	134	815	829	3	0	12	0	2	0	1	0	3	14	14	0	1	14	1	15	
426	1483981222	1478094782.sql	1483981222.sql	2017-01-09 17:00:22	2888	8	95	134	135	829	832	1	0	3	0	0	0	0	0	1	3	3	0	0	3	0	3	
427	1484062277	1483981222.sql	1484062277.sql	2017-01-10 15:31:17	2889	8	95	135	135	832	834	0	0	0	0	2	0	0	0	0	2	2	0	0	2	0	2	
428	1484064455	1484062277.sql	1484064455.sql	2017-01-10 16:07:35	2889	8	95	135	135	834	834	0	0	0	0	0	0	0	0	0	0	0	0	0	0	0	0	
429	1484122748	1484064455.sql	1484122748.sql	2017-01-11 08:19:08	2890	8	95	135	135	834	833	0	0	0	0	0	1	0	0	0	-1	0	1	0	0	1	1	
430	1485442237	1484122748.sql	1485442237.sql	2017-01-26 14:50:37	2905	8	96	135	135	833	833	0	0	0	0	0	0	0	0	0	0	0	0	0	0	0	0	
431	1485495344	1485442237.sql	1485495344.sql	2017-01-27 05:35:44	2906	8	96	135	135	833	833	0	0	0	0	0	0	0	0	0	0	0	0	0	0	0	0	
432	1485501106	1485495344.sql	1485501106.sql	2017-01-27 07:11:46	2906	8	96	135	135	833	833	0	0	0	0	0	0	0	0	0	0	0	0	0	0	0	0	
433	1485502949	1485501106.sql	1485502949.sql	2017-01-27 07:42:29	2906	8	96	135	135	833	833	0	0	0	0	0	0	0	0	0	0	0	0	0	0	0	0	
434	1485793020	1485502949.sql	1485793020.sql	2017-01-30 16:17:00	2909	8	96	135	135	833	833	0	0	0	0	0	0	0	0	0	0	0	0	0	0	0	0	
435	1486143933	1485793020.sql	1486143933.sql	2017-02-03 17:45:33	2914	8	96	135	135	833	833	0	0	0	0	0	0	0	0	0	0	0	0	0	0	0	0	
436	1486144466	1486143933.sql	1486144466.sql	2017-02-03 17:54:26	2914	8	96	135	135	833	833	0	0	0	0	0	0	0	0	0	0	0	0	0	0	0	0	
437	1486194581	1486144466.sql	1486194581.sql	2017-02-04 07:49:41	2914	8	96	135	135	833	833	0	0	0	0	0	0	0	0	0	0	0	0	0	0	0	0	
438	1486366842	1486194581.sql	1486366842.sql	2017-02-06 07:40:42	2916	8	96	135	135	833	833	0	0	0	0	0	0	0	0	0	0	0	0	0	0	0	0	
439	1488118880	1486366842.sql	1488118880.sql	2017-02-26 14:21:20	2936	9	97	135	132	833	800	1	4	16	49	0	0	0	0	-3	-33	16	49	0	16	49	65	
440	1488215314	1488118880.sql	1488215314.sql	2017-02-27 17:08:34	2937	9	97	132	132	800	801	0	0	0	0	1	0	1	0	0	1	1	0	1	1	1	2	
441	1488386043	1488215314.sql	1488386043.sql	2017-03-01 16:34:03	2939	9	97	132	132	801	801	0	0	0	0	0	0	2	0	0	0	0	0	2	0	2	2	
442	1488809876	1488386043.sql	1488809876.sql	2017-03-06 14:17:56	2944	9	97	132	132	801	801	0	0	0	0	0	0	2	0	0	0	0	0	2	0	2	2	
443	1488891874	1488809876.sql	1488891874.sql	2017-03-07 13:04:34	2945	9	97	132	132	801	801	0	0	0	0	0	0	0	0	0	0	0	0	0	0	0	0	
444	1489593668	1488891874.sql	1489593668.sql	2017-03-15 16:01:08	2953	9	98	132	132	801	798	0	0	0	0	1	4	0	0	0	-3	1	4	0	1	4	5	
445	1489722711	1489593668.sql	1489722711.sql	2017-03-17 03:51:51	2955	9	98	132	132	798	802	0	0	0	0	4	0	0	0	0	4	4	0	0	4	0	4	
446	1490073137	1489722711.sql	1490073137.sql	2017-03-21 05:12:17	2959	9	98	132	132	802	800	0	0	0	0	0	2	0	0	0	-2	0	2	0	0	2	2	
447	1491238153	1490073137.sql	1491238153.sql	2017-04-03 16:49:13	2972	9	98	132	133	800	803	1	0	3	0	1	1	0	0	1	3	4	1	0	4	1	5	
448	1491560374	1491238153.sql	1491560374.sql	2017-04-07 10:19:34	2976	9	98	133	133	803	803	0	0	0	0	0	0	0	0	0	0	0	0	0	0	0	0	
449	1491709687	1491560374.sql	1491709687.sql	2017-04-09 03:48:07	2978	9	98	133	132	803	798	0	1	0	4	0	1	0	0	-1	-5	0	5	0	0	5	5	
450	1491710526	1491709687.sql	1491710526.sql	2017-04-09 04:02:06	2978	9	98	132	132	798	798	0	0	0	0	0	0	0	0	0	0	0	0	0	0	0	0	
451	1491719141	1491710526.sql	1491719141.sql	2017-04-09 06:25:41	2978	9	98	132	129	798	785	0	3	0	13	0	0	0	0	-3	-13	0	13	0	0	13	13	
452	1491757408	1491719141.sql	1491757408.sql	2017-04-09 17:03:28	2978	9	98	129	129	785	785	0	0	0	0	0	0	0	0	0	0	0	0	0	0	0	0	
453	1491817384	1491757408.sql	1491817384.sql	2017-04-10 09:43:04	2979	9	98	129	129	785	785	0	0	0	0	0	0	0	0	0	0	0	0	0	0	0	0	
454	1491896180	1491817384.sql	1491896180.sql	2017-04-11 07:36:20	2980	9	98	129	129	785	786	1	1	4	3	2	2	0	0	0	1	6	5	0	6	5	11	
455	1491950526	1491896180.sql	1491950526.sql	2017-04-11 22:42:06	2981	9	99	129	129	786	786	0	0	0	0	0	0	0	0	0	0	0	0	0	0	0	0	
456	1491988557	1491950526.sql	1491988557.sql	2017-04-12 09:15:57	2981	9	99	129	129	786	787	0	0	0	0	1	0	0	0	0	1	1	0	0	1	0	1	
457	1492504496	1491988557.sql	1492504496.sql	2017-04-18 08:34:56	2987	9	99	129	128	787	779	0	1	0	8	0	0	0	0	-1	-8	0	8	0	0	8	8	
458	1492629878	1492504496.sql	1492629878.sql	2017-04-19 19:24:38	2989	9	99	128	129	779	782	1	0	3	0	0	0	0	0	1	3	3	0	0	3	0	3	
459	1492781253	1492629878.sql	1492781253.sql	2017-04-21 13:27:33	2990	9	99	129	129	782	782	0	0	0	0	0	0	1	0	0	0	0	0	1	0	1	1	
460	1493046000	1492781253.sql	1493046000.sql	2017-04-24 15:00:00	2993	9	99	129	130	782	785	1	0	4	0	0	1	0	0	1	3	4	1	0	4	1	5	
461	1493114093	1493046000.sql	1493114093.sql	2017-04-25 09:54:53	2994	9	99	130	130	785	785	0	0	0	0	0	0	0	0	0	0	0	0	0	0	0	0	
462	1493185823	1493114093.sql	1493185823.sql	2017-04-26 05:50:23	2995	9	99	130	130	785	785	0	0	0	0	0	0	0	0	0	0	0	0	0	0	0	0	
463	1493268646	1493185823.sql	1493268646.sql	2017-04-27 04:50:46	2996	9	99	130	130	785	785	0	0	0	0	0	0	0	0	0	0	0	0	0	0	0	0	
464	1493281477	1493268646.sql	1493281477.sql	2017-04-27 08:24:37	2996	9	99	130	130	785	785	0	0	0	0	0	0	0	0	0	0	0	0	0	0	0	0	
465	1493303050	1493281477.sql	1493303050.sql	2017-04-27 14:24:10	2996	9	99	130	130	785	785	0	0	0	0	0	0	0	0	0	0	0	0	0	0	0	0	
466	1493960727	1493303050.sql	1493960727.sql	2017-05-05 05:05:27	3004	9	99	130	130	785	785	0	0	0	0	0	0	1	0	0	0	0	0	1	0	1	1	
467	1493993327	1493960727.sql	1493993327.sql	2017-05-05 14:08:47	3004	9	99	130	130	785	785	0	0	0	0	0	0	1	0	0	0	0	0	1	0	1	1	
468	1494176582	1493993327.sql	1494176582.sql	2017-05-07 17:03:02	3006	9	99	130	130	785	785	0	0	0	0	0	0	1	0	0	0	0	0	1	0	1	1	
469	1494268231	1494176582.sql	1494268231.sql	2017-05-08 18:30:31	3008	9	99	130	130	785	785	0	0	0	0	0	0	0	0	0	0	0	0	0	0	0	0	
470	1494268252	1494268231.sql	1494268252.sql	2017-05-08 18:30:52	3008	9	99	130	130	785	785	0	0	0	0	0	0	0	0	0	0	0	0	0	0	0	0	
471	1494313414	1494268252.sql	1494313414.sql	2017-05-09 07:03:34	3008	9	99	130	130	785	785	0	0	0	0	0	0	1	0	0	0	0	0	1	0	1	1	
472	1494353073	1494313414.sql	1494353073.sql	2017-05-09 18:04:33	3009	9	99	130	130	785	785	0	0	0	0	0	0	0	0	0	0	0	0	0	0	0	0	
473	1494557918	1494353073.sql	1494557918.sql	2017-05-12 02:58:38	3011	9	100	130	130	785	785	0	0	0	0	0	0	1	0	0	0	0	0	1	0	1	1	
474	1494960175	1494557918.sql	1494960175.sql	2017-05-16 18:42:55	3016	9	100	130	130	785	785	0	0	0	0	0	0	1	0	0	0	0	0	1	0	1	1	
475	1494962532	1494960175.sql	1494962532.sql	2017-05-16 19:22:12	3016	9	100	130	130	785	785	0	0	0	0	0	0	1	0	0	0	0	0	1	0	1	1	
476	1496387227	1494962532.sql	1496387227.sql	2017-06-02 07:07:07	3032	9	100	130	130	785	785	0	0	0	0	0	0	0	0	0	0	0	0	0	0	0	0	
477	1496503329	1496387227.sql	1496503329.sql	2017-06-03 15:22:09	3033	9	100	130	130	785	785	0	0	0	0	0	0	0	0	0	0	0	0	0	0	0	0	
478	1496504219	1496503329.sql	1496504219.sql	2017-06-03 15:36:59	3033	9	100	130	130	785	785	0	0	0	0	0	0	0	0	0	0	0	0	0	0	0	0	
479	1496579354	1496504219.sql	1496579354.sql	2017-06-04 12:29:14	3034	9	100	130	130	785	785	0	0	0	0	0	0	1	0	0	0	0	0	1	0	1	1	
480	1496926013	1496579354.sql	1496926013.sql	2017-06-08 12:46:53	3038	9	100	130	130	785	785	0	0	0	0	0	0	0	0	0	0	0	0	0	0	0	0	
481	1497206302	1496926013.sql	1497206302.sql	2017-06-11 18:38:22	3042	9	101	130	130	785	785	0	0	0	0	0	0	0	0	0	0	0	0	0	0	0	0	
482	1497215492	1497206302.sql	1497215492.sql	2017-06-11 21:11:32	3042	9	101	130	130	785	787	1	1	5	3	0	0	0	0	0	2	5	3	0	5	3	8	
483	1497274498	1497215492.sql	1497274498.sql	2017-06-12 13:34:58	3042	9	101	130	130	787	787	0	0	0	0	0	0	0	0	0	0	0	0	0	0	0	0	
484	1497424008	1497274498.sql	1497424008.sql	2017-06-14 07:06:48	3044	9	101	130	130	787	787	0	0	0	0	0	0	0	0	0	0	0	0	0	0	0	0	
485	1497873047	1497424008.sql	1497873047.sql	2017-06-19 11:50:47	3049	9	101	130	130	787	787	0	0	0	0	0	0	0	0	0	0	0	0	0	0	0	0	
486	1497876541	1497873047.sql	1497876541.sql	2017-06-19 12:49:01	3049	9	101	130	130	787	787	0	0	0	0	0	0	0	0	0	0	0	0	0	0	0	0	
487	1497878130	1497876541.sql	1497878130.sql	2017-06-19 13:15:30	3049	9	101	130	130	787	787	0	0	0	0	0	0	0	0	0	0	0	0	0	0	0	0	
488	1498146046	1497878130.sql	1498146046.sql	2017-06-22 15:40:46	3052	9	101	130	131	787	790	1	0	3	0	0	0	0	0	1	3	3	0	0	3	0	3	
489	1498322971	1498146046.sql	1498322971.sql	2017-06-24 16:49:31	3054	9	101	131	131	790	790	0	0	0	0	0	0	0	0	0	0	0	0	0	0	0	0	
490	1498500702	1498322971.sql	1498500702.sql	2017-06-26 18:11:42	3057	9	101	131	131	790	790	0	0	0	0	0	0	0	0	0	0	0	0	0	0	0	0	
491	1498921983	1498500702.sql	1498921983.sql	2017-07-01 15:13:03	3061	9	101	131	131	790	790	0	0	0	0	0	0	0	0	0	0	0	0	0	0	0	0	
492	1498946574	1498921983.sql	1498946574.sql	2017-07-01 22:02:54	3062	9	101	131	131	790	790	0	0	0	0	0	0	0	0	0	0	0	0	0	0	0	0	
493	1501055612	1498946574.sql	1501055612.sql	2017-07-26 07:53:32	3086	9	102	131	131	790	790	0	0	0	0	0	0	0	0	0	0	0	0	0	0	0	0	
494	1501096637	1501055612.sql	1501096637.sql	2017-07-26 19:17:17	3087	9	102	131	131	790	790	0	0	0	0	0	0	2	0	0	0	0	0	2	0	2	2	
495	1501174674	1501096637.sql	1501174674.sql	2017-07-27 16:57:54	3087	9	102	131	131	790	790	0	0	0	0	0	0	0	0	0	0	0	0	0	0	0	0	
496	1501252704	1501174674.sql	1501252704.sql	2017-07-28 14:38:24	3088	9	102	131	132	790	798	1	0	8	0	0	0	2	0	1	8	8	0	2	8	2	10	
497	1501252724	1501252704.sql	1501252724.sql	2017-07-28 14:38:44	3088	9	102	132	132	798	798	0	0	0	0	0	0	2	0	0	0	0	0	2	0	2	2	
498	1501951545	1501252724.sql	1501951545.sql	2017-08-05 16:45:45	3096	9	102	132	132	798	798	0	0	0	0	0	0	0	0	0	0	0	0	0	0	0	0	
499	1503466218	1501951545.sql	1503466218.sql	2017-08-23 05:30:18	3114	9	103	132	132	798	799	0	0	0	0	1	0	0	0	0	1	1	0	0	1	0	1	
500	1505384462	1503466218.sql	1505384462.sql	2017-09-14 10:21:02	3136	9	104	132	133	799	805	1	0	7	0	0	1	0	0	1	6	7	1	0	7	1	8	
501	1505540626	1505384462.sql	1505540626.sql	2017-09-16 05:43:46	3138	9	104	133	133	805	803	0	0	0	0	1	3	0	0	0	-2	1	3	0	1	3	4	
502	1505548036	1505540626.sql	1505548036.sql	2017-09-16 07:47:16	3138	9	104	133	133	803	803	0	0	0	0	0	0	1	0	0	0	0	0	1	0	1	1	
503	1505802783	1505548036.sql	1505802783.sql	2017-09-19 06:33:03	3141	9	104	133	133	803	803	1	1	5	5	0	0	0	0	0	0	5	5	0	5	5	10	
504	1505839184	1505802783.sql	1505839184.sql	2017-09-19 16:39:44	3141	9	104	133	133	803	803	0	0	0	0	0	0	59	0	0	0	0	0	59	0	59	59	
505	1506141575	1505839184.sql	1506141575.sql	2017-09-23 04:39:35	3145	9	104	133	134	803	808	1	0	5	0	1	1	0	0	1	5	6	1	0	6	1	7	
506	1506154914	1506141575.sql	1506154914.sql	2017-09-23 08:21:54	3145	9	104	134	135	808	813	1	0	5	0	0	0	0	0	1	5	5	0	0	5	0	5	
507	1506188249	1506154914.sql	1506188249.sql	2017-09-23 17:37:29	3146	9	104	135	135	813	813	0	0	0	0	0	0	0	0	0	0	0	0	0	0	0	0	
508	1506237200	1506188249.sql	1506237200.sql	2017-09-24 07:13:20	3146	9	104	135	135	813	818	0	0	0	0	5	0	0	0	0	5	5	0	0	5	0	5	
509	1506509042	1506237200.sql	1506509042.sql	2017-09-27 10:44:02	3149	9	104	135	135	818	818	0	0	0	0	0	0	0	0	0	0	0	0	0	0	0	0	
510	1507622966	1506509042.sql	1507622966.sql	2017-10-10 08:09:26	3162	9	104	135	135	818	818	0	0	0	0	0	0	0	0	0	0	0	0	0	0	0	0	
511	1507702755	1507622966.sql	1507702755.sql	2017-10-11 06:19:15	3163	9	104	135	135	818	818	0	0	0	0	0	0	0	0	0	0	0	0	0	0	0	0	
512	1507916360	1507702755.sql	1507916360.sql	2017-10-13 17:39:20	3166	9	105	135	135	818	819	0	0	0	0	1	0	1	0	0	1	1	0	1	1	1	2	
513	1507949732	1507916360.sql	1507949732.sql	2017-10-14 02:55:32	3166	9	105	135	135	819	819	0	0	0	0	0	0	61	0	0	0	0	0	61	0	61	61	
514	1507951341	1507949732.sql	1507951341.sql	2017-10-14 03:22:21	3166	9	105	135	135	819	819	0	0	0	0	0	0	2	0	0	0	0	0	2	0	2	2	
515	1508341852	1507951341.sql	1508341852.sql	2017-10-18 15:50:52	3170	9	105	135	135	819	819	0	0	0	0	0	0	0	0	0	0	0	0	0	0	0	0	
